TRACT,YEAR,UNIT TYPE,UNITS,OCCUPIED,UNOCCUPIED,VACANCY RATE
1,2012,Mobile Home,0,0,0,
1,2012,Multifamily,51,51,0,0
1,2012,Single Family - Detached,1283,1283,0,0
1,2020,Mobile Home,0,0,0,
1,2020,Multifamily,51,51,0,0
1,2020,Single Family - Detached,1283,1269,14,0.0109119251753702
1,2025,Mobile Home,0,0,0,
1,2025,Multifamily,51,51,0,0
1,2025,Single Family - Detached,1283,1276,7,0.00545596258768511
1,2030,Mobile Home,0,0,0,
1,2030,Multifamily,55,53,2,0.0363636363636364
1,2030,Single Family - Detached,1283,1269,14,0.0109119251753702
1,2035,Mobile Home,0,0,0,
1,2035,Multifamily,55,51,4,0.0727272727272727
1,2035,Single Family - Detached,1283,1270,13,0.0101325019485581
1,2040,Mobile Home,0,0,0,
1,2040,Multifamily,55,50,5,0.0909090909090909
1,2040,Single Family - Detached,1283,1268,15,0.0116913484021824
1,2045,Mobile Home,0,0,0,
1,2045,Multifamily,65,56,9,0.138461538461538
1,2045,Single Family - Detached,1281,1252,29,0.0226385636221702
1,2050,Mobile Home,0,0,0,
1,2050,Multifamily,89,82,7,0.0786516853932584
1,2050,Single Family - Detached,1281,1250,31,0.024199843871975
10,2012,Mobile Home,0,0,0,
10,2012,Multifamily,1722,1684,38,0.0220673635307782
10,2012,Single Family - Detached,933,906,27,0.0289389067524116
10,2020,Mobile Home,0,0,0,
10,2020,Multifamily,1898,1841,57,0.030031612223393
10,2020,Single Family - Detached,937,910,27,0.0288153681963714
10,2025,Mobile Home,0,0,0,
10,2025,Multifamily,1958,1906,52,0.0265577119509704
10,2025,Single Family - Detached,891,867,24,0.0269360269360269
10,2030,Mobile Home,0,0,0,
10,2030,Multifamily,2590,2556,34,0.0131274131274131
10,2030,Single Family - Detached,583,575,8,0.0137221269296741
10,2035,Mobile Home,0,0,0,
10,2035,Multifamily,2819,2786,33,0.0117062788222774
10,2035,Single Family - Detached,459,454,5,0.0108932461873638
10,2040,Mobile Home,0,0,0,
10,2040,Multifamily,3093,3057,36,0.011639185257032
10,2040,Single Family - Detached,377,375,2,0.00530503978779841
10,2045,Mobile Home,0,0,0,
10,2045,Multifamily,3263,3204,59,0.0180815200735519
10,2045,Single Family - Detached,366,361,5,0.0136612021857923
10,2050,Mobile Home,0,0,0,
10,2050,Multifamily,3263,3163,100,0.0306466441924609
10,2050,Single Family - Detached,366,360,6,0.0163934426229508
100.01,2012,Mobile Home,0,0,0,
100.01,2012,Multifamily,228,193,35,0.153508771929825
100.01,2012,Single Family - Detached,894,883,11,0.0123042505592841
100.01,2020,Mobile Home,0,0,0,
100.01,2020,Multifamily,230,195,35,0.152173913043478
100.01,2020,Single Family - Detached,894,883,11,0.0123042505592841
100.01,2025,Mobile Home,0,0,0,
100.01,2025,Multifamily,230,195,35,0.152173913043478
100.01,2025,Single Family - Detached,894,884,10,0.0111856823266219
100.01,2030,Mobile Home,0,0,0,
100.01,2030,Multifamily,230,194,36,0.156521739130435
100.01,2030,Single Family - Detached,894,884,10,0.0111856823266219
100.01,2035,Mobile Home,0,0,0,
100.01,2035,Multifamily,230,190,40,0.173913043478261
100.01,2035,Single Family - Detached,894,885,9,0.0100671140939597
100.01,2040,Mobile Home,0,0,0,
100.01,2040,Multifamily,230,188,42,0.182608695652174
100.01,2040,Single Family - Detached,894,883,11,0.0123042505592841
100.01,2045,Mobile Home,0,0,0,
100.01,2045,Multifamily,230,185,45,0.195652173913043
100.01,2045,Single Family - Detached,894,883,11,0.0123042505592841
100.01,2050,Mobile Home,0,0,0,
100.01,2050,Multifamily,230,183,47,0.204347826086957
100.01,2050,Single Family - Detached,894,883,11,0.0123042505592841
100.03,2012,Mobile Home,0,0,0,
100.03,2012,Multifamily,0,0,0,
100.03,2012,Single Family - Detached,1478,1450,28,0.0189445196211096
100.03,2020,Mobile Home,0,0,0,
100.03,2020,Multifamily,0,0,0,
100.03,2020,Single Family - Detached,1478,1450,28,0.0189445196211096
100.03,2025,Mobile Home,0,0,0,
100.03,2025,Multifamily,0,0,0,
100.03,2025,Single Family - Detached,1478,1450,28,0.0189445196211096
100.03,2030,Mobile Home,0,0,0,
100.03,2030,Multifamily,0,0,0,
100.03,2030,Single Family - Detached,1478,1450,28,0.0189445196211096
100.03,2035,Mobile Home,0,0,0,
100.03,2035,Multifamily,0,0,0,
100.03,2035,Single Family - Detached,1478,1451,27,0.0182679296346414
100.03,2040,Mobile Home,0,0,0,
100.03,2040,Multifamily,0,0,0,
100.03,2040,Single Family - Detached,1478,1450,28,0.0189445196211096
100.03,2045,Mobile Home,0,0,0,
100.03,2045,Multifamily,0,0,0,
100.03,2045,Single Family - Detached,1478,1450,28,0.0189445196211096
100.03,2050,Mobile Home,0,0,0,
100.03,2050,Multifamily,0,0,0,
100.03,2050,Single Family - Detached,1478,1450,28,0.0189445196211096
100.04,2012,Mobile Home,0,0,0,
100.04,2012,Multifamily,0,0,0,
100.04,2012,Single Family - Detached,1096,1089,7,0.00638686131386861
100.04,2020,Mobile Home,0,0,0,
100.04,2020,Multifamily,0,0,0,
100.04,2020,Single Family - Detached,1096,1089,7,0.00638686131386861
100.04,2025,Mobile Home,0,0,0,
100.04,2025,Multifamily,0,0,0,
100.04,2025,Single Family - Detached,1096,1089,7,0.00638686131386861
100.04,2030,Mobile Home,0,0,0,
100.04,2030,Multifamily,0,0,0,
100.04,2030,Single Family - Detached,1096,1089,7,0.00638686131386861
100.04,2035,Mobile Home,0,0,0,
100.04,2035,Multifamily,0,0,0,
100.04,2035,Single Family - Detached,1096,1089,7,0.00638686131386861
100.04,2040,Mobile Home,0,0,0,
100.04,2040,Multifamily,0,0,0,
100.04,2040,Single Family - Detached,1096,1089,7,0.00638686131386861
100.04,2045,Mobile Home,0,0,0,
100.04,2045,Multifamily,0,0,0,
100.04,2045,Single Family - Detached,1096,1089,7,0.00638686131386861
100.04,2050,Mobile Home,0,0,0,
100.04,2050,Multifamily,0,0,0,
100.04,2050,Single Family - Detached,1096,1089,7,0.00638686131386861
100.05,2012,Mobile Home,90,90,0,0
100.05,2012,Multifamily,1034,1034,0,0
100.05,2012,Single Family - Detached,824,824,0,0
100.05,2020,Mobile Home,90,90,0,0
100.05,2020,Multifamily,1146,1146,0,0
100.05,2020,Single Family - Detached,821,821,0,0
100.05,2025,Mobile Home,90,90,0,0
100.05,2025,Multifamily,1304,1304,0,0
100.05,2025,Single Family - Detached,821,821,0,0
100.05,2030,Mobile Home,90,90,0,0
100.05,2030,Multifamily,1514,1513,1,0.000660501981505945
100.05,2030,Single Family - Detached,806,806,0,0
100.05,2035,Mobile Home,90,90,0,0
100.05,2035,Multifamily,1527,1524,3,0.00196463654223969
100.05,2035,Single Family - Detached,806,806,0,0
100.05,2040,Mobile Home,90,90,0,0
100.05,2040,Multifamily,1527,1521,6,0.00392927308447937
100.05,2040,Single Family - Detached,823,822,1,0.00121506682867558
100.05,2045,Mobile Home,90,90,0,0
100.05,2045,Multifamily,1527,1519,8,0.00523903077930583
100.05,2045,Single Family - Detached,823,821,2,0.00243013365735115
100.05,2050,Mobile Home,90,88,2,0.0222222222222222
100.05,2050,Multifamily,1527,1518,9,0.00589390962671906
100.05,2050,Single Family - Detached,823,821,2,0.00243013365735115
100.09,2012,Mobile Home,132,132,0,0
100.09,2012,Multifamily,1019,968,51,0.0500490677134446
100.09,2012,Single Family - Detached,554,551,3,0.00541516245487365
100.09,2020,Mobile Home,132,132,0,0
100.09,2020,Multifamily,1018,971,47,0.0461689587426326
100.09,2020,Single Family - Detached,551,548,3,0.00544464609800363
100.09,2025,Mobile Home,132,132,0,0
100.09,2025,Multifamily,1015,975,40,0.0394088669950739
100.09,2025,Single Family - Detached,551,549,2,0.00362976406533575
100.09,2030,Mobile Home,132,131,1,0.00757575757575758
100.09,2030,Multifamily,1068,1025,43,0.0402621722846442
100.09,2030,Single Family - Detached,551,549,2,0.00362976406533575
100.09,2035,Mobile Home,132,131,1,0.00757575757575758
100.09,2035,Multifamily,1065,1025,40,0.0375586854460094
100.09,2035,Single Family - Detached,551,549,2,0.00362976406533575
100.09,2040,Mobile Home,123,122,1,0.00813008130081301
100.09,2040,Multifamily,1234,1183,51,0.0413290113452188
100.09,2040,Single Family - Detached,549,546,3,0.00546448087431694
100.09,2045,Mobile Home,9,8,1,0.111111111111111
100.09,2045,Multifamily,1470,1405,65,0.0442176870748299
100.09,2045,Single Family - Detached,542,539,3,0.00553505535055351
100.09,2050,Mobile Home,9,8,1,0.111111111111111
100.09,2050,Multifamily,1470,1404,66,0.0448979591836735
100.09,2050,Single Family - Detached,539,536,3,0.00556586270871985
100.10,2012,Mobile Home,396,396,0,0
100.10,2012,Multifamily,731,726,5,0.00683994528043776
100.10,2012,Single Family - Detached,564,564,0,0
100.10,2020,Mobile Home,396,396,0,0
100.10,2020,Multifamily,731,724,7,0.00957592339261286
100.10,2020,Single Family - Detached,564,563,1,0.00177304964539007
100.10,2025,Mobile Home,396,396,0,0
100.10,2025,Multifamily,731,724,7,0.00957592339261286
100.10,2025,Single Family - Detached,564,564,0,0
100.10,2030,Mobile Home,269,268,1,0.00371747211895911
100.10,2030,Multifamily,1052,1034,18,0.0171102661596958
100.10,2030,Single Family - Detached,564,563,1,0.00177304964539007
100.10,2035,Mobile Home,0,0,0,
100.10,2035,Multifamily,1642,1609,33,0.0200974421437272
100.10,2035,Single Family - Detached,564,564,0,0
100.10,2040,Mobile Home,0,0,0,
100.10,2040,Multifamily,1642,1601,41,0.0249695493300853
100.10,2040,Single Family - Detached,564,562,2,0.00354609929078014
100.10,2045,Mobile Home,0,0,0,
100.10,2045,Multifamily,1642,1591,51,0.0310596833130329
100.10,2045,Single Family - Detached,564,561,3,0.00531914893617021
100.10,2050,Mobile Home,0,0,0,
100.10,2050,Multifamily,1642,1587,55,0.0334957369062119
100.10,2050,Single Family - Detached,564,560,4,0.00709219858156028
100.11,2012,Mobile Home,0,0,0,
100.11,2012,Multifamily,157,139,18,0.114649681528662
100.11,2012,Single Family - Detached,775,766,9,0.0116129032258065
100.11,2020,Mobile Home,0,0,0,
100.11,2020,Multifamily,174,172,2,0.0114942528735632
100.11,2020,Single Family - Detached,775,766,9,0.0116129032258065
100.11,2025,Mobile Home,0,0,0,
100.11,2025,Multifamily,192,191,1,0.00520833333333333
100.11,2025,Single Family - Detached,775,766,9,0.0116129032258065
100.11,2030,Mobile Home,0,0,0,
100.11,2030,Multifamily,199,195,4,0.0201005025125628
100.11,2030,Single Family - Detached,775,766,9,0.0116129032258065
100.11,2035,Mobile Home,0,0,0,
100.11,2035,Multifamily,199,189,10,0.050251256281407
100.11,2035,Single Family - Detached,775,766,9,0.0116129032258065
100.11,2040,Mobile Home,0,0,0,
100.11,2040,Multifamily,199,185,14,0.0703517587939698
100.11,2040,Single Family - Detached,775,765,10,0.0129032258064516
100.11,2045,Mobile Home,0,0,0,
100.11,2045,Multifamily,199,181,18,0.0904522613065327
100.11,2045,Single Family - Detached,775,764,11,0.0141935483870968
100.11,2050,Mobile Home,0,0,0,
100.11,2050,Multifamily,199,178,21,0.105527638190955
100.11,2050,Single Family - Detached,775,763,12,0.0154838709677419
100.12,2012,Mobile Home,0,0,0,
100.12,2012,Multifamily,919,907,12,0.0130576713819369
100.12,2012,Single Family - Detached,317,314,3,0.00946372239747634
100.12,2020,Mobile Home,0,0,0,
100.12,2020,Multifamily,919,907,12,0.0130576713819369
100.12,2020,Single Family - Detached,332,329,3,0.00903614457831325
100.12,2025,Mobile Home,0,0,0,
100.12,2025,Multifamily,919,910,9,0.00979325353645267
100.12,2025,Single Family - Detached,332,330,2,0.00602409638554217
100.12,2030,Mobile Home,0,0,0,
100.12,2030,Multifamily,979,970,9,0.00919305413687436
100.12,2030,Single Family - Detached,328,326,2,0.00609756097560976
100.12,2035,Mobile Home,0,0,0,
100.12,2035,Multifamily,992,988,4,0.00403225806451613
100.12,2035,Single Family - Detached,328,326,2,0.00609756097560976
100.12,2040,Mobile Home,0,0,0,
100.12,2040,Multifamily,1000,995,5,0.005
100.12,2040,Single Family - Detached,394,392,2,0.0050761421319797
100.12,2045,Mobile Home,0,0,0,
100.12,2045,Multifamily,1000,994,6,0.006
100.12,2045,Single Family - Detached,395,393,2,0.00506329113924051
100.12,2050,Mobile Home,0,0,0,
100.12,2050,Multifamily,1000,993,7,0.007
100.12,2050,Single Family - Detached,408,406,2,0.00490196078431373
100.13,2012,Mobile Home,88,88,0,0
100.13,2012,Multifamily,945,946,-1,-0.00105820105820106
100.13,2012,Single Family - Detached,466,465,1,0.00214592274678112
100.13,2020,Mobile Home,88,88,0,0
100.13,2020,Multifamily,913,915,-2,-0.00219058050383352
100.13,2020,Single Family - Detached,454,453,1,0.00220264317180617
100.13,2025,Mobile Home,88,88,0,0
100.13,2025,Multifamily,913,916,-3,-0.00328587075575027
100.13,2025,Single Family - Detached,451,450,1,0.00221729490022173
100.13,2030,Mobile Home,88,86,2,0.0227272727272727
100.13,2030,Multifamily,1194,1195,-1,-0.000837520938023451
100.13,2030,Single Family - Detached,380,381,-1,-0.00263157894736842
100.13,2035,Mobile Home,88,86,2,0.0227272727272727
100.13,2035,Multifamily,1630,1629,1,0.000613496932515337
100.13,2035,Single Family - Detached,256,257,-1,-0.00390625
100.13,2040,Mobile Home,88,87,1,0.0113636363636364
100.13,2040,Multifamily,1860,1851,9,0.00483870967741936
100.13,2040,Single Family - Detached,242,242,0,0
100.13,2045,Mobile Home,25,25,0,0
100.13,2045,Multifamily,2054,2042,12,0.00584225900681597
100.13,2045,Single Family - Detached,242,241,1,0.00413223140495868
100.13,2050,Mobile Home,25,23,2,0.08
100.13,2050,Multifamily,2078,2065,13,0.00625601539942252
100.13,2050,Single Family - Detached,242,241,1,0.00413223140495868
100.14,2012,Mobile Home,0,0,0,
100.14,2012,Multifamily,1470,1430,40,0.0272108843537415
100.14,2012,Single Family - Detached,2281,2174,107,0.0469092503288032
100.14,2020,Mobile Home,0,0,0,
100.14,2020,Multifamily,3719,3616,103,0.0276956171013713
100.14,2020,Single Family - Detached,2283,2176,107,0.046868155935173
100.14,2025,Mobile Home,0,0,0,
100.14,2025,Multifamily,3789,3698,91,0.0240168910002639
100.14,2025,Single Family - Detached,2289,2186,103,0.0449978156400175
100.14,2030,Mobile Home,0,0,0,
100.14,2030,Multifamily,3789,3676,113,0.0298231723409871
100.14,2030,Single Family - Detached,2289,2181,108,0.0471821756225426
100.14,2035,Mobile Home,0,0,0,
100.14,2035,Multifamily,3789,3676,113,0.0298231723409871
100.14,2035,Single Family - Detached,2290,2183,107,0.0467248908296943
100.14,2040,Mobile Home,0,0,0,
100.14,2040,Multifamily,3789,3658,131,0.0345737661652151
100.14,2040,Single Family - Detached,2300,2187,113,0.0491304347826087
100.14,2045,Mobile Home,0,0,0,
100.14,2045,Multifamily,3789,3642,147,0.0387965162311956
100.14,2045,Single Family - Detached,2307,2183,124,0.0537494581707846
100.14,2050,Mobile Home,0,0,0,
100.14,2050,Multifamily,3789,3635,154,0.040643969385062
100.14,2050,Single Family - Detached,2318,2193,125,0.0539257981018119
100.15,2012,Mobile Home,0,0,0,
100.15,2012,Multifamily,84,82,2,0.0238095238095238
100.15,2012,Single Family - Detached,586,587,-1,-0.00170648464163823
100.15,2020,Mobile Home,0,0,0,
100.15,2020,Multifamily,84,82,2,0.0238095238095238
100.15,2020,Single Family - Detached,1648,1593,55,0.033373786407767
100.15,2025,Mobile Home,0,0,0,
100.15,2025,Multifamily,1551,1516,35,0.0225660863958736
100.15,2025,Single Family - Detached,1725,1697,28,0.016231884057971
100.15,2030,Mobile Home,0,0,0,
100.15,2030,Multifamily,4065,3987,78,0.0191881918819188
100.15,2030,Single Family - Detached,2491,2436,55,0.0220794861501405
100.15,2035,Mobile Home,0,0,0,
100.15,2035,Multifamily,7029,6900,129,0.0183525394793
100.15,2035,Single Family - Detached,2505,2463,42,0.0167664670658683
100.15,2040,Mobile Home,0,0,0,
100.15,2040,Multifamily,7392,7239,153,0.0206980519480519
100.15,2040,Single Family - Detached,2853,2791,62,0.0217315106905012
100.15,2045,Mobile Home,0,0,0,
100.15,2045,Multifamily,7867,7696,171,0.0217363671030889
100.15,2045,Single Family - Detached,2953,2879,74,0.0250592617676939
100.15,2050,Mobile Home,0,0,0,
100.15,2050,Multifamily,8044,7863,181,0.0225012431626057
100.15,2050,Single Family - Detached,2951,2873,78,0.026431718061674
101.03,2012,Mobile Home,637,577,60,0.0941915227629513
101.03,2012,Multifamily,495,470,25,0.0505050505050505
101.03,2012,Single Family - Detached,675,653,22,0.0325925925925926
101.03,2020,Mobile Home,637,577,60,0.0941915227629513
101.03,2020,Multifamily,694,660,34,0.0489913544668588
101.03,2020,Single Family - Detached,676,653,23,0.0340236686390533
101.03,2025,Mobile Home,637,547,90,0.141287284144427
101.03,2025,Multifamily,707,665,42,0.0594059405940594
101.03,2025,Single Family - Detached,777,766,11,0.0141570141570142
101.03,2030,Mobile Home,637,547,90,0.141287284144427
101.03,2030,Multifamily,709,662,47,0.0662905500705219
101.03,2030,Single Family - Detached,815,802,13,0.0159509202453988
101.03,2035,Mobile Home,637,547,90,0.141287284144427
101.03,2035,Multifamily,709,669,40,0.0564174894217207
101.03,2035,Single Family - Detached,815,805,10,0.0122699386503067
101.03,2040,Mobile Home,373,334,39,0.10455764075067
101.03,2040,Multifamily,992,918,74,0.0745967741935484
101.03,2040,Single Family - Detached,815,803,12,0.0147239263803681
101.03,2045,Mobile Home,373,334,39,0.10455764075067
101.03,2045,Multifamily,992,911,81,0.0816532258064516
101.03,2045,Single Family - Detached,815,801,14,0.0171779141104294
101.03,2050,Mobile Home,373,332,41,0.109919571045576
101.03,2050,Multifamily,992,908,84,0.0846774193548387
101.03,2050,Single Family - Detached,784,774,10,0.0127551020408163
101.04,2012,Mobile Home,0,0,0,
101.04,2012,Multifamily,133,119,14,0.105263157894737
101.04,2012,Single Family - Detached,933,911,22,0.0235798499464094
101.04,2020,Mobile Home,0,0,0,
101.04,2020,Multifamily,133,119,14,0.105263157894737
101.04,2020,Single Family - Detached,933,910,23,0.0246516613076099
101.04,2025,Mobile Home,0,0,0,
101.04,2025,Multifamily,133,116,17,0.12781954887218
101.04,2025,Single Family - Detached,982,959,23,0.0234215885947047
101.04,2030,Mobile Home,0,0,0,
101.04,2030,Multifamily,133,115,18,0.135338345864662
101.04,2030,Single Family - Detached,982,959,23,0.0234215885947047
101.04,2035,Mobile Home,0,0,0,
101.04,2035,Multifamily,133,115,18,0.135338345864662
101.04,2035,Single Family - Detached,982,959,23,0.0234215885947047
101.04,2040,Mobile Home,0,0,0,
101.04,2040,Multifamily,135,132,3,0.0222222222222222
101.04,2040,Single Family - Detached,982,959,23,0.0234215885947047
101.04,2045,Mobile Home,0,0,0,
101.04,2045,Multifamily,135,131,4,0.0296296296296296
101.04,2045,Single Family - Detached,982,959,23,0.0234215885947047
101.04,2050,Mobile Home,0,0,0,
101.04,2050,Multifamily,135,131,4,0.0296296296296296
101.04,2050,Single Family - Detached,982,959,23,0.0234215885947047
101.06,2012,Mobile Home,223,223,0,0
101.06,2012,Multifamily,820,788,32,0.0390243902439024
101.06,2012,Single Family - Detached,485,481,4,0.00824742268041237
101.06,2020,Mobile Home,223,223,0,0
101.06,2020,Multifamily,820,787,33,0.0402439024390244
101.06,2020,Single Family - Detached,485,479,6,0.0123711340206186
101.06,2025,Mobile Home,223,223,0,0
101.06,2025,Multifamily,820,787,33,0.0402439024390244
101.06,2025,Single Family - Detached,485,483,2,0.00412371134020619
101.06,2030,Mobile Home,223,222,1,0.00448430493273543
101.06,2030,Multifamily,837,801,36,0.043010752688172
101.06,2030,Single Family - Detached,484,481,3,0.00619834710743802
101.06,2035,Mobile Home,223,221,2,0.00896860986547085
101.06,2035,Multifamily,939,902,37,0.0394036208732694
101.06,2035,Single Family - Detached,481,481,0,0
101.06,2040,Mobile Home,223,221,2,0.00896860986547085
101.06,2040,Multifamily,1059,1013,46,0.0434372049102927
101.06,2040,Single Family - Detached,481,477,4,0.00831600831600832
101.06,2045,Mobile Home,223,220,3,0.0134529147982063
101.06,2045,Multifamily,1142,1109,33,0.0288966725043783
101.06,2045,Single Family - Detached,481,474,7,0.0145530145530146
101.06,2050,Mobile Home,223,217,6,0.0269058295964126
101.06,2050,Multifamily,1212,1181,31,0.0255775577557756
101.06,2050,Single Family - Detached,482,475,7,0.0145228215767635
101.07,2012,Mobile Home,405,396,9,0.0222222222222222
101.07,2012,Multifamily,393,367,26,0.0661577608142494
101.07,2012,Single Family - Detached,980,974,6,0.00612244897959184
101.07,2020,Mobile Home,394,388,6,0.0152284263959391
101.07,2020,Multifamily,371,334,37,0.0997304582210243
101.07,2020,Single Family - Detached,980,972,8,0.00816326530612245
101.07,2025,Mobile Home,336,329,7,0.0208333333333333
101.07,2025,Multifamily,476,447,29,0.0609243697478992
101.07,2025,Single Family - Detached,980,973,7,0.00714285714285714
101.07,2030,Mobile Home,288,279,9,0.03125
101.07,2030,Multifamily,1029,979,50,0.0485908649173955
101.07,2030,Single Family - Detached,1005,998,7,0.00696517412935323
101.07,2035,Mobile Home,223,219,4,0.0179372197309417
101.07,2035,Multifamily,1255,1203,52,0.0414342629482072
101.07,2035,Single Family - Detached,1005,1000,5,0.00497512437810945
101.07,2040,Mobile Home,150,148,2,0.0133333333333333
101.07,2040,Multifamily,1426,1370,56,0.0392706872370266
101.07,2040,Single Family - Detached,1010,1003,7,0.00693069306930693
101.07,2045,Mobile Home,150,147,3,0.02
101.07,2045,Multifamily,1426,1359,67,0.046984572230014
101.07,2045,Single Family - Detached,1010,1003,7,0.00693069306930693
101.07,2050,Mobile Home,150,143,7,0.0466666666666667
101.07,2050,Multifamily,1428,1359,69,0.0483193277310924
101.07,2050,Single Family - Detached,1010,1003,7,0.00693069306930693
101.09,2012,Mobile Home,0,0,0,
101.09,2012,Multifamily,162,148,14,0.0864197530864197
101.09,2012,Single Family - Detached,1035,1014,21,0.0202898550724638
101.09,2020,Mobile Home,0,0,0,
101.09,2020,Multifamily,162,148,14,0.0864197530864197
101.09,2020,Single Family - Detached,1035,1014,21,0.0202898550724638
101.09,2025,Mobile Home,0,0,0,
101.09,2025,Multifamily,162,145,17,0.104938271604938
101.09,2025,Single Family - Detached,1035,1014,21,0.0202898550724638
101.09,2030,Mobile Home,0,0,0,
101.09,2030,Multifamily,162,144,18,0.111111111111111
101.09,2030,Single Family - Detached,1035,1013,22,0.021256038647343
101.09,2035,Mobile Home,0,0,0,
101.09,2035,Multifamily,162,144,18,0.111111111111111
101.09,2035,Single Family - Detached,1035,1014,21,0.0202898550724638
101.09,2040,Mobile Home,0,0,0,
101.09,2040,Multifamily,168,164,4,0.0238095238095238
101.09,2040,Single Family - Detached,1035,1014,21,0.0202898550724638
101.09,2045,Mobile Home,0,0,0,
101.09,2045,Multifamily,168,164,4,0.0238095238095238
101.09,2045,Single Family - Detached,1035,1013,22,0.021256038647343
101.09,2050,Mobile Home,0,0,0,
101.09,2050,Multifamily,168,164,4,0.0238095238095238
101.09,2050,Single Family - Detached,1035,1014,21,0.0202898550724638
101.10,2012,Mobile Home,161,75,86,0.53416149068323
101.10,2012,Multifamily,899,888,11,0.0122358175750834
101.10,2012,Single Family - Detached,1105,1099,6,0.00542986425339366
101.10,2020,Mobile Home,161,76,85,0.527950310559006
101.10,2020,Multifamily,951,938,13,0.0136698212407992
101.10,2020,Single Family - Detached,1105,1097,8,0.00723981900452489
101.10,2025,Mobile Home,99,77,22,0.222222222222222
101.10,2025,Multifamily,1248,1207,41,0.0328525641025641
101.10,2025,Single Family - Detached,1192,1186,6,0.00503355704697987
101.10,2030,Mobile Home,99,75,24,0.242424242424242
101.10,2030,Multifamily,1341,1301,40,0.0298284862043251
101.10,2030,Single Family - Detached,1273,1266,7,0.00549882168106834
101.10,2035,Mobile Home,99,75,24,0.242424242424242
101.10,2035,Multifamily,1345,1307,38,0.0282527881040892
101.10,2035,Single Family - Detached,1273,1267,6,0.00471327572663001
101.10,2040,Mobile Home,99,75,24,0.242424242424242
101.10,2040,Multifamily,1401,1352,49,0.0349750178443969
101.10,2040,Single Family - Detached,1273,1266,7,0.00549882168106834
101.10,2045,Mobile Home,99,74,25,0.252525252525253
101.10,2045,Multifamily,1401,1348,53,0.0378301213418986
101.10,2045,Single Family - Detached,1273,1265,8,0.00628436763550668
101.10,2050,Mobile Home,99,70,29,0.292929292929293
101.10,2050,Multifamily,1401,1348,53,0.0378301213418986
101.10,2050,Single Family - Detached,1273,1265,8,0.00628436763550668
101.11,2012,Mobile Home,177,166,11,0.0621468926553672
101.11,2012,Multifamily,294,256,38,0.129251700680272
101.11,2012,Single Family - Detached,350,349,1,0.00285714285714286
101.11,2020,Mobile Home,177,167,10,0.0564971751412429
101.11,2020,Multifamily,294,257,37,0.125850340136054
101.11,2020,Single Family - Detached,350,349,1,0.00285714285714286
101.11,2025,Mobile Home,177,167,10,0.0564971751412429
101.11,2025,Multifamily,294,260,34,0.115646258503401
101.11,2025,Single Family - Detached,350,349,1,0.00285714285714286
101.11,2030,Mobile Home,177,167,10,0.0564971751412429
101.11,2030,Multifamily,294,259,35,0.119047619047619
101.11,2030,Single Family - Detached,350,348,2,0.00571428571428571
101.11,2035,Mobile Home,177,167,10,0.0564971751412429
101.11,2035,Multifamily,294,258,36,0.122448979591837
101.11,2035,Single Family - Detached,350,349,1,0.00285714285714286
101.11,2040,Mobile Home,177,167,10,0.0564971751412429
101.11,2040,Multifamily,294,257,37,0.125850340136054
101.11,2040,Single Family - Detached,350,349,1,0.00285714285714286
101.11,2045,Mobile Home,177,167,10,0.0564971751412429
101.11,2045,Multifamily,294,256,38,0.129251700680272
101.11,2045,Single Family - Detached,350,349,1,0.00285714285714286
101.11,2050,Mobile Home,177,165,12,0.0677966101694915
101.11,2050,Multifamily,294,255,39,0.13265306122449
101.11,2050,Single Family - Detached,350,349,1,0.00285714285714286
101.12,2012,Mobile Home,99,94,5,0.0505050505050505
101.12,2012,Multifamily,1379,1281,98,0.0710659898477157
101.12,2012,Single Family - Detached,35,33,2,0.0571428571428571
101.12,2020,Mobile Home,99,96,3,0.0303030303030303
101.12,2020,Multifamily,1379,1279,100,0.0725163161711385
101.12,2020,Single Family - Detached,35,31,4,0.114285714285714
101.12,2025,Mobile Home,99,74,25,0.252525252525253
101.12,2025,Multifamily,1439,1387,52,0.0361362056984017
101.12,2025,Single Family - Detached,35,32,3,0.0857142857142857
101.12,2030,Mobile Home,99,72,27,0.272727272727273
101.12,2030,Multifamily,1469,1414,55,0.0374404356705242
101.12,2030,Single Family - Detached,35,31,4,0.114285714285714
101.12,2035,Mobile Home,99,73,26,0.262626262626263
101.12,2035,Multifamily,1473,1419,54,0.0366598778004073
101.12,2035,Single Family - Detached,35,31,4,0.114285714285714
101.12,2040,Mobile Home,99,72,27,0.272727272727273
101.12,2040,Multifamily,1553,1483,70,0.0450740502253702
101.12,2040,Single Family - Detached,35,29,6,0.171428571428571
101.12,2045,Mobile Home,99,71,28,0.282828282828283
101.12,2045,Multifamily,1564,1493,71,0.0453964194373402
101.12,2045,Single Family - Detached,35,28,7,0.2
101.12,2050,Mobile Home,99,67,32,0.323232323232323
101.12,2050,Multifamily,1564,1493,71,0.0453964194373402
101.12,2050,Single Family - Detached,35,28,7,0.2
102,2012,Mobile Home,110,99,11,0.1
102,2012,Multifamily,1400,1191,209,0.149285714285714
102,2012,Single Family - Detached,1439,1341,98,0.0681028492008339
102,2020,Mobile Home,110,99,11,0.1
102,2020,Multifamily,1400,1202,198,0.141428571428571
102,2020,Single Family - Detached,1440,1331,109,0.0756944444444444
102,2025,Mobile Home,110,104,6,0.0545454545454545
102,2025,Multifamily,1490,1307,183,0.122818791946309
102,2025,Single Family - Detached,1420,1317,103,0.0725352112676056
102,2030,Mobile Home,90,84,6,0.0666666666666667
102,2030,Multifamily,1584,1390,194,0.122474747474747
102,2030,Single Family - Detached,1401,1295,106,0.0756602426837973
102,2035,Mobile Home,90,84,6,0.0666666666666667
102,2035,Multifamily,1696,1503,193,0.113797169811321
102,2035,Single Family - Detached,1339,1248,91,0.0679611650485437
102,2040,Mobile Home,90,84,6,0.0666666666666667
102,2040,Multifamily,1868,1663,205,0.109743040685225
102,2040,Single Family - Detached,1261,1171,90,0.0713719270420301
102,2045,Mobile Home,90,84,6,0.0666666666666667
102,2045,Multifamily,1923,1706,217,0.112844513780551
102,2045,Single Family - Detached,1236,1140,96,0.0776699029126214
102,2050,Mobile Home,90,82,8,0.0888888888888889
102,2050,Multifamily,1923,1705,218,0.113364534581383
102,2050,Single Family - Detached,1236,1141,95,0.0768608414239482
103,2012,Mobile Home,0,0,0,
103,2012,Multifamily,337,328,9,0.0267062314540059
103,2012,Single Family - Detached,1257,1215,42,0.0334128878281623
103,2020,Mobile Home,0,0,0,
103,2020,Multifamily,337,326,11,0.0326409495548961
103,2020,Single Family - Detached,1258,1211,47,0.0373608903020668
103,2025,Mobile Home,0,0,0,
103,2025,Multifamily,337,326,11,0.0326409495548961
103,2025,Single Family - Detached,1258,1218,40,0.0317965023847377
103,2030,Mobile Home,0,0,0,
103,2030,Multifamily,337,325,12,0.0356083086053412
103,2030,Single Family - Detached,1263,1225,38,0.0300870942201108
103,2035,Mobile Home,0,0,0,
103,2035,Multifamily,337,324,13,0.0385756676557863
103,2035,Single Family - Detached,1263,1225,38,0.0300870942201108
103,2040,Mobile Home,0,0,0,
103,2040,Multifamily,346,336,10,0.0289017341040462
103,2040,Single Family - Detached,1260,1224,36,0.0285714285714286
103,2045,Mobile Home,0,0,0,
103,2045,Multifamily,353,341,12,0.0339943342776204
103,2045,Single Family - Detached,1255,1218,37,0.0294820717131474
103,2050,Mobile Home,0,0,0,
103,2050,Multifamily,359,346,13,0.0362116991643454
103,2050,Single Family - Detached,1253,1218,35,0.0279329608938547
104.01,2012,Mobile Home,0,0,0,
104.01,2012,Multifamily,316,318,-2,-0.00632911392405063
104.01,2012,Single Family - Detached,488,452,36,0.0737704918032787
104.01,2020,Mobile Home,0,0,0,
104.01,2020,Multifamily,335,331,4,0.0119402985074627
104.01,2020,Single Family - Detached,484,439,45,0.0929752066115702
104.01,2025,Mobile Home,0,0,0,
104.01,2025,Multifamily,360,359,1,0.00277777777777778
104.01,2025,Single Family - Detached,480,446,34,0.0708333333333333
104.01,2030,Mobile Home,0,0,0,
104.01,2030,Multifamily,360,354,6,0.0166666666666667
104.01,2030,Single Family - Detached,478,437,41,0.0857740585774059
104.01,2035,Mobile Home,0,0,0,
104.01,2035,Multifamily,386,374,12,0.0310880829015544
104.01,2035,Single Family - Detached,478,440,38,0.0794979079497908
104.01,2040,Mobile Home,0,0,0,
104.01,2040,Multifamily,386,361,25,0.0647668393782383
104.01,2040,Single Family - Detached,478,431,47,0.098326359832636
104.01,2045,Mobile Home,0,0,0,
104.01,2045,Multifamily,386,358,28,0.0725388601036269
104.01,2045,Single Family - Detached,478,425,53,0.110878661087866
104.01,2050,Mobile Home,0,0,0,
104.01,2050,Multifamily,386,355,31,0.0803108808290155
104.01,2050,Single Family - Detached,478,420,58,0.121338912133891
104.02,2012,Mobile Home,0,0,0,
104.02,2012,Multifamily,1028,968,60,0.0583657587548638
104.02,2012,Single Family - Detached,882,842,40,0.0453514739229025
104.02,2020,Mobile Home,0,0,0,
104.02,2020,Multifamily,1029,975,54,0.0524781341107872
104.02,2020,Single Family - Detached,884,841,43,0.0486425339366516
104.02,2025,Mobile Home,0,0,0,
104.02,2025,Multifamily,1031,980,51,0.049466537342386
104.02,2025,Single Family - Detached,884,846,38,0.0429864253393665
104.02,2030,Mobile Home,0,0,0,
104.02,2030,Multifamily,1033,980,53,0.0513068731848984
104.02,2030,Single Family - Detached,886,849,37,0.0417607223476298
104.02,2035,Mobile Home,0,0,0,
104.02,2035,Multifamily,1067,1036,31,0.0290534208059981
104.02,2035,Single Family - Detached,884,848,36,0.0407239819004525
104.02,2040,Mobile Home,0,0,0,
104.02,2040,Multifamily,1171,1128,43,0.0367207514944492
104.02,2040,Single Family - Detached,856,829,27,0.0315420560747664
104.02,2045,Mobile Home,0,0,0,
104.02,2045,Multifamily,1171,1128,43,0.0367207514944492
104.02,2045,Single Family - Detached,856,828,28,0.0327102803738318
104.02,2050,Mobile Home,0,0,0,
104.02,2050,Multifamily,1171,1126,45,0.0384286934244236
104.02,2050,Single Family - Detached,856,827,29,0.0338785046728972
105.01,2012,Mobile Home,75,74,1,0.0133333333333333
105.01,2012,Multifamily,109,108,1,0.00917431192660551
105.01,2012,Single Family - Detached,419,372,47,0.112171837708831
105.01,2020,Mobile Home,75,75,0,0
105.01,2020,Multifamily,109,109,0,0
105.01,2020,Single Family - Detached,419,369,50,0.119331742243437
105.01,2025,Mobile Home,0,0,0,
105.01,2025,Multifamily,255,240,15,0.0588235294117647
105.01,2025,Single Family - Detached,419,369,50,0.119331742243437
105.01,2030,Mobile Home,0,0,0,
105.01,2030,Multifamily,257,240,17,0.066147859922179
105.01,2030,Single Family - Detached,420,370,50,0.119047619047619
105.01,2035,Mobile Home,0,0,0,
105.01,2035,Multifamily,264,245,19,0.071969696969697
105.01,2035,Single Family - Detached,417,368,49,0.117505995203837
105.01,2040,Mobile Home,0,0,0,
105.01,2040,Multifamily,281,250,31,0.110320284697509
105.01,2040,Single Family - Detached,411,359,52,0.126520681265207
105.01,2045,Mobile Home,0,0,0,
105.01,2045,Multifamily,282,249,33,0.117021276595745
105.01,2045,Single Family - Detached,411,356,55,0.1338199513382
105.01,2050,Mobile Home,0,0,0,
105.01,2050,Multifamily,282,249,33,0.117021276595745
105.01,2050,Single Family - Detached,411,356,55,0.1338199513382
105.02,2012,Mobile Home,124,101,23,0.185483870967742
105.02,2012,Multifamily,809,777,32,0.0395550061804697
105.02,2012,Single Family - Detached,1070,1016,54,0.0504672897196262
105.02,2020,Mobile Home,124,102,22,0.17741935483871
105.02,2020,Multifamily,1028,989,39,0.0379377431906615
105.02,2020,Single Family - Detached,969,924,45,0.0464396284829721
105.02,2025,Mobile Home,124,102,22,0.17741935483871
105.02,2025,Multifamily,1294,1243,51,0.0394126738794436
105.02,2025,Single Family - Detached,969,935,34,0.0350877192982456
105.02,2030,Mobile Home,124,101,23,0.185483870967742
105.02,2030,Multifamily,1566,1512,54,0.0344827586206897
105.02,2030,Single Family - Detached,981,947,34,0.0346585117227319
105.02,2035,Mobile Home,124,101,23,0.185483870967742
105.02,2035,Multifamily,1600,1535,65,0.040625
105.02,2035,Single Family - Detached,981,954,27,0.0275229357798165
105.02,2040,Mobile Home,124,101,23,0.185483870967742
105.02,2040,Multifamily,1950,1874,76,0.038974358974359
105.02,2040,Single Family - Detached,963,923,40,0.0415368639667705
105.02,2045,Mobile Home,124,101,23,0.185483870967742
105.02,2045,Multifamily,1963,1882,81,0.0412633723892002
105.02,2045,Single Family - Detached,963,916,47,0.0488058151609553
105.02,2050,Mobile Home,124,99,25,0.201612903225806
105.02,2050,Multifamily,2001,1920,81,0.04047976011994
105.02,2050,Single Family - Detached,958,911,47,0.0490605427974948
106.01,2012,Mobile Home,0,0,0,
106.01,2012,Multifamily,83,51,32,0.385542168674699
106.01,2012,Single Family - Detached,1120,856,264,0.235714285714286
106.01,2020,Mobile Home,0,0,0,
106.01,2020,Multifamily,83,57,26,0.313253012048193
106.01,2020,Single Family - Detached,1121,836,285,0.254237288135593
106.01,2025,Mobile Home,0,0,0,
106.01,2025,Multifamily,83,58,25,0.301204819277108
106.01,2025,Single Family - Detached,1121,837,284,0.253345227475468
106.01,2030,Mobile Home,0,0,0,
106.01,2030,Multifamily,83,58,25,0.301204819277108
106.01,2030,Single Family - Detached,1121,837,284,0.253345227475468
106.01,2035,Mobile Home,0,0,0,
106.01,2035,Multifamily,83,59,24,0.289156626506024
106.01,2035,Single Family - Detached,1121,838,283,0.252453166815343
106.01,2040,Mobile Home,0,0,0,
106.01,2040,Multifamily,83,59,24,0.289156626506024
106.01,2040,Single Family - Detached,1121,837,284,0.253345227475468
106.01,2045,Mobile Home,0,0,0,
106.01,2045,Multifamily,83,59,24,0.289156626506024
106.01,2045,Single Family - Detached,1121,836,285,0.254237288135593
106.01,2050,Mobile Home,0,0,0,
106.01,2050,Multifamily,83,59,24,0.289156626506024
106.01,2050,Single Family - Detached,1121,836,285,0.254237288135593
108,2012,Mobile Home,0,0,0,
108,2012,Multifamily,556,471,85,0.152877697841727
108,2012,Single Family - Detached,681,601,80,0.117474302496329
108,2020,Mobile Home,0,0,0,
108,2020,Multifamily,559,465,94,0.168157423971377
108,2020,Single Family - Detached,688,597,91,0.132267441860465
108,2025,Mobile Home,0,0,0,
108,2025,Multifamily,559,479,80,0.143112701252236
108,2025,Single Family - Detached,688,614,74,0.107558139534884
108,2030,Mobile Home,0,0,0,
108,2030,Multifamily,559,469,90,0.161001788908766
108,2030,Single Family - Detached,688,612,76,0.11046511627907
108,2035,Mobile Home,0,0,0,
108,2035,Multifamily,559,475,84,0.150268336314848
108,2035,Single Family - Detached,688,617,71,0.103197674418605
108,2040,Mobile Home,0,0,0,
108,2040,Multifamily,596,512,84,0.140939597315436
108,2040,Single Family - Detached,671,608,63,0.0938897168405365
108,2045,Mobile Home,0,0,0,
108,2045,Multifamily,640,581,59,0.0921875
108,2045,Single Family - Detached,648,598,50,0.0771604938271605
108,2050,Mobile Home,0,0,0,
108,2050,Multifamily,670,607,63,0.0940298507462687
108,2050,Single Family - Detached,629,578,51,0.0810810810810811
109,2012,Mobile Home,0,0,0,
109,2012,Multifamily,144,119,25,0.173611111111111
109,2012,Single Family - Detached,678,601,77,0.113569321533923
109,2020,Mobile Home,0,0,0,
109,2020,Multifamily,144,111,33,0.229166666666667
109,2020,Single Family - Detached,687,607,80,0.116448326055313
109,2025,Mobile Home,0,0,0,
109,2025,Multifamily,144,120,24,0.166666666666667
109,2025,Single Family - Detached,687,620,67,0.0975254730713246
109,2030,Mobile Home,0,0,0,
109,2030,Multifamily,145,119,26,0.179310344827586
109,2030,Single Family - Detached,687,619,68,0.098981077147016
109,2035,Mobile Home,0,0,0,
109,2035,Multifamily,145,121,24,0.16551724137931
109,2035,Single Family - Detached,687,621,66,0.0960698689956332
109,2040,Mobile Home,0,0,0,
109,2040,Multifamily,168,134,34,0.202380952380952
109,2040,Single Family - Detached,678,614,64,0.0943952802359882
109,2045,Mobile Home,0,0,0,
109,2045,Multifamily,186,145,41,0.220430107526882
109,2045,Single Family - Detached,668,600,68,0.101796407185629
109,2050,Mobile Home,0,0,0,
109,2050,Multifamily,187,141,46,0.245989304812834
109,2050,Single Family - Detached,668,598,70,0.104790419161677
11,2012,Mobile Home,0,0,0,
11,2012,Multifamily,1189,1135,54,0.0454163162321278
11,2012,Single Family - Detached,591,566,25,0.0423011844331641
11,2020,Mobile Home,0,0,0,
11,2020,Multifamily,1214,1166,48,0.0395387149917628
11,2020,Single Family - Detached,571,560,11,0.0192644483362522
11,2025,Mobile Home,0,0,0,
11,2025,Multifamily,1702,1662,40,0.0235017626321974
11,2025,Single Family - Detached,466,461,5,0.0107296137339056
11,2030,Mobile Home,0,0,0,
11,2030,Multifamily,1702,1654,48,0.0282021151586369
11,2030,Single Family - Detached,466,458,8,0.0171673819742489
11,2035,Mobile Home,0,0,0,
11,2035,Multifamily,1702,1652,50,0.0293772032902468
11,2035,Single Family - Detached,466,460,6,0.0128755364806867
11,2040,Mobile Home,0,0,0,
11,2040,Multifamily,1702,1641,61,0.0358401880141011
11,2040,Single Family - Detached,466,457,9,0.01931330472103
11,2045,Mobile Home,0,0,0,
11,2045,Multifamily,1702,1623,79,0.0464159811985899
11,2045,Single Family - Detached,466,455,11,0.0236051502145923
11,2050,Mobile Home,0,0,0,
11,2050,Multifamily,1702,1591,111,0.0652173913043478
11,2050,Single Family - Detached,466,454,12,0.0257510729613734
110,2012,Mobile Home,0,0,0,
110,2012,Multifamily,951,777,174,0.182965299684543
110,2012,Single Family - Detached,583,531,52,0.0891938250428816
110,2020,Mobile Home,0,0,0,
110,2020,Multifamily,951,775,176,0.185068349106204
110,2020,Single Family - Detached,591,537,54,0.0913705583756345
110,2025,Mobile Home,0,0,0,
110,2025,Multifamily,973,807,166,0.170606372045221
110,2025,Single Family - Detached,581,539,42,0.072289156626506
110,2030,Mobile Home,0,0,0,
110,2030,Multifamily,979,817,162,0.165474974463739
110,2030,Single Family - Detached,576,537,39,0.0677083333333333
110,2035,Mobile Home,0,0,0,
110,2035,Multifamily,988,826,162,0.163967611336032
110,2035,Single Family - Detached,571,533,38,0.0665499124343257
110,2040,Mobile Home,0,0,0,
110,2040,Multifamily,999,838,161,0.161161161161161
110,2040,Single Family - Detached,569,532,37,0.0650263620386643
110,2045,Mobile Home,0,0,0,
110,2045,Multifamily,1000,829,171,0.171
110,2045,Single Family - Detached,569,528,41,0.0720562390158172
110,2050,Mobile Home,0,0,0,
110,2050,Multifamily,1000,826,174,0.174
110,2050,Single Family - Detached,570,530,40,0.0701754385964912
111,2012,Mobile Home,0,0,0,
111,2012,Multifamily,671,582,89,0.132637853949329
111,2012,Single Family - Detached,1135,1052,83,0.0731277533039648
111,2020,Mobile Home,0,0,0,
111,2020,Multifamily,685,605,80,0.116788321167883
111,2020,Single Family - Detached,1147,1054,93,0.0810810810810811
111,2025,Mobile Home,0,0,0,
111,2025,Multifamily,685,613,72,0.105109489051095
111,2025,Single Family - Detached,1147,1078,69,0.0601569311246731
111,2030,Mobile Home,0,0,0,
111,2030,Multifamily,701,630,71,0.101283880171184
111,2030,Single Family - Detached,1138,1063,75,0.0659050966608084
111,2035,Mobile Home,0,0,0,
111,2035,Multifamily,712,643,69,0.0969101123595506
111,2035,Single Family - Detached,1134,1073,61,0.0537918871252205
111,2040,Mobile Home,0,0,0,
111,2040,Multifamily,752,681,71,0.0944148936170213
111,2040,Single Family - Detached,1111,1058,53,0.0477047704770477
111,2045,Mobile Home,0,0,0,
111,2045,Multifamily,752,660,92,0.122340425531915
111,2045,Single Family - Detached,1111,1040,71,0.0639063906390639
111,2050,Mobile Home,0,0,0,
111,2050,Multifamily,752,653,99,0.131648936170213
111,2050,Single Family - Detached,1116,1039,77,0.0689964157706093
113,2012,Mobile Home,0,0,0,
113,2012,Multifamily,0,0,0,
113,2012,Single Family - Detached,54,38,16,0.296296296296296
113,2020,Mobile Home,0,0,0,
113,2020,Multifamily,0,0,0,
113,2020,Single Family - Detached,54,39,15,0.277777777777778
113,2025,Mobile Home,0,0,0,
113,2025,Multifamily,0,0,0,
113,2025,Single Family - Detached,54,40,14,0.259259259259259
113,2030,Mobile Home,0,0,0,
113,2030,Multifamily,0,0,0,
113,2030,Single Family - Detached,54,39,15,0.277777777777778
113,2035,Mobile Home,0,0,0,
113,2035,Multifamily,0,0,0,
113,2035,Single Family - Detached,54,40,14,0.259259259259259
113,2040,Mobile Home,0,0,0,
113,2040,Multifamily,0,0,0,
113,2040,Single Family - Detached,54,40,14,0.259259259259259
113,2045,Mobile Home,0,0,0,
113,2045,Multifamily,0,0,0,
113,2045,Single Family - Detached,54,39,15,0.277777777777778
113,2050,Mobile Home,0,0,0,
113,2050,Multifamily,0,0,0,
113,2050,Single Family - Detached,54,40,14,0.259259259259259
116.01,2012,Mobile Home,0,0,0,
116.01,2012,Multifamily,1100,1028,72,0.0654545454545455
116.01,2012,Single Family - Detached,631,597,34,0.0538827258320127
116.01,2020,Mobile Home,0,0,0,
116.01,2020,Multifamily,1100,1027,73,0.0663636363636364
116.01,2020,Single Family - Detached,634,598,36,0.056782334384858
116.01,2025,Mobile Home,0,0,0,
116.01,2025,Multifamily,1100,1031,69,0.0627272727272727
116.01,2025,Single Family - Detached,634,605,29,0.0457413249211356
116.01,2030,Mobile Home,0,0,0,
116.01,2030,Multifamily,1100,1025,75,0.0681818181818182
116.01,2030,Single Family - Detached,634,605,29,0.0457413249211356
116.01,2035,Mobile Home,0,0,0,
116.01,2035,Multifamily,1117,1046,71,0.0635631154879141
116.01,2035,Single Family - Detached,634,608,26,0.0410094637223975
116.01,2040,Mobile Home,0,0,0,
116.01,2040,Multifamily,1143,1064,79,0.0691163604549431
116.01,2040,Single Family - Detached,634,604,30,0.0473186119873817
116.01,2045,Mobile Home,0,0,0,
116.01,2045,Multifamily,1114,1027,87,0.078096947935368
116.01,2045,Single Family - Detached,593,560,33,0.0556492411467116
116.01,2050,Mobile Home,0,0,0,
116.01,2050,Multifamily,1138,1043,95,0.0834797891036907
116.01,2050,Single Family - Detached,587,552,35,0.0596252129471891
116.02,2012,Mobile Home,95,91,4,0.0421052631578947
116.02,2012,Multifamily,478,457,21,0.0439330543933054
116.02,2012,Single Family - Detached,422,406,16,0.037914691943128
116.02,2020,Mobile Home,95,91,4,0.0421052631578947
116.02,2020,Multifamily,478,456,22,0.0460251046025105
116.02,2020,Single Family - Detached,422,402,20,0.0473933649289099
116.02,2025,Mobile Home,95,92,3,0.0315789473684211
116.02,2025,Multifamily,478,458,20,0.0418410041841004
116.02,2025,Single Family - Detached,422,407,15,0.0355450236966825
116.02,2030,Mobile Home,95,91,4,0.0421052631578947
116.02,2030,Multifamily,478,455,23,0.0481171548117155
116.02,2030,Single Family - Detached,422,407,15,0.0355450236966825
116.02,2035,Mobile Home,95,91,4,0.0421052631578947
116.02,2035,Multifamily,478,455,23,0.0481171548117155
116.02,2035,Single Family - Detached,422,408,14,0.033175355450237
116.02,2040,Mobile Home,95,91,4,0.0421052631578947
116.02,2040,Multifamily,478,452,26,0.0543933054393305
116.02,2040,Single Family - Detached,422,403,19,0.0450236966824645
116.02,2045,Mobile Home,95,91,4,0.0421052631578947
116.02,2045,Multifamily,478,449,29,0.0606694560669456
116.02,2045,Single Family - Detached,422,398,24,0.0568720379146919
116.02,2050,Mobile Home,95,89,6,0.0631578947368421
116.02,2050,Multifamily,301,286,15,0.0498338870431894
116.02,2050,Single Family - Detached,294,279,15,0.0510204081632653
117,2012,Mobile Home,0,0,0,
117,2012,Multifamily,1497,1377,120,0.0801603206412826
117,2012,Single Family - Detached,934,904,30,0.0321199143468951
117,2020,Mobile Home,0,0,0,
117,2020,Multifamily,1504,1381,123,0.081781914893617
117,2020,Single Family - Detached,1009,980,29,0.0287413280475719
117,2025,Mobile Home,0,0,0,
117,2025,Multifamily,1505,1390,115,0.0764119601328904
117,2025,Single Family - Detached,988,961,27,0.0273279352226721
117,2030,Mobile Home,0,0,0,
117,2030,Multifamily,1475,1363,112,0.0759322033898305
117,2030,Single Family - Detached,966,938,28,0.0289855072463768
117,2035,Mobile Home,0,0,0,
117,2035,Multifamily,1464,1358,106,0.0724043715846995
117,2035,Single Family - Detached,948,921,27,0.0284810126582278
117,2040,Mobile Home,0,0,0,
117,2040,Multifamily,1401,1290,111,0.0792291220556745
117,2040,Single Family - Detached,917,886,31,0.0338058887677208
117,2045,Mobile Home,0,0,0,
117,2045,Multifamily,1427,1313,114,0.0798878766643308
117,2045,Single Family - Detached,849,817,32,0.0376914016489988
117,2050,Mobile Home,0,0,0,
117,2050,Multifamily,2355,2192,163,0.0692144373673036
117,2050,Single Family - Detached,850,816,34,0.04
118.01,2012,Mobile Home,0,0,0,
118.01,2012,Multifamily,278,256,22,0.079136690647482
118.01,2012,Single Family - Detached,833,800,33,0.0396158463385354
118.01,2020,Mobile Home,0,0,0,
118.01,2020,Multifamily,250,231,19,0.076
118.01,2020,Single Family - Detached,782,757,25,0.0319693094629156
118.01,2025,Mobile Home,0,0,0,
118.01,2025,Multifamily,296,286,10,0.0337837837837838
118.01,2025,Single Family - Detached,752,733,19,0.0252659574468085
118.01,2030,Mobile Home,0,0,0,
118.01,2030,Multifamily,402,373,29,0.0721393034825871
118.01,2030,Single Family - Detached,732,712,20,0.0273224043715847
118.01,2035,Mobile Home,0,0,0,
118.01,2035,Multifamily,584,543,41,0.0702054794520548
118.01,2035,Single Family - Detached,725,706,19,0.0262068965517241
118.01,2040,Mobile Home,0,0,0,
118.01,2040,Multifamily,946,875,71,0.0750528541226216
118.01,2040,Single Family - Detached,724,700,24,0.0331491712707182
118.01,2045,Mobile Home,0,0,0,
118.01,2045,Multifamily,1108,1021,87,0.0785198555956679
118.01,2045,Single Family - Detached,724,695,29,0.0400552486187845
118.01,2050,Mobile Home,0,0,0,
118.01,2050,Multifamily,1108,1006,102,0.092057761732852
118.01,2050,Single Family - Detached,724,692,32,0.0441988950276243
118.02,2012,Mobile Home,87,84,3,0.0344827586206897
118.02,2012,Multifamily,870,830,40,0.0459770114942529
118.02,2012,Single Family - Detached,886,879,7,0.00790067720090293
118.02,2020,Mobile Home,56,55,1,0.0178571428571429
118.02,2020,Multifamily,1043,991,52,0.049856184084372
118.02,2020,Single Family - Detached,816,809,7,0.00857843137254902
118.02,2025,Mobile Home,0,0,0,
118.02,2025,Multifamily,1582,1507,75,0.0474083438685209
118.02,2025,Single Family - Detached,814,810,4,0.00491400491400491
118.02,2030,Mobile Home,0,0,0,
118.02,2030,Multifamily,1833,1765,68,0.0370976541189307
118.02,2030,Single Family - Detached,799,796,3,0.00375469336670839
118.02,2035,Mobile Home,0,0,0,
118.02,2035,Multifamily,1911,1838,73,0.0381998953427525
118.02,2035,Single Family - Detached,799,796,3,0.00375469336670839
118.02,2040,Mobile Home,0,0,0,
118.02,2040,Multifamily,2226,2135,91,0.0408805031446541
118.02,2040,Single Family - Detached,799,793,6,0.00750938673341677
118.02,2045,Mobile Home,0,0,0,
118.02,2045,Multifamily,2286,2192,94,0.0411198600174978
118.02,2045,Single Family - Detached,799,788,11,0.0137672090112641
118.02,2050,Mobile Home,0,0,0,
118.02,2050,Multifamily,2286,2186,100,0.0437445319335083
118.02,2050,Single Family - Detached,799,786,13,0.016270337922403
119.02,2012,Mobile Home,0,0,0,
119.02,2012,Multifamily,557,545,12,0.0215439856373429
119.02,2012,Single Family - Detached,1272,1172,100,0.0786163522012579
119.02,2020,Mobile Home,0,0,0,
119.02,2020,Multifamily,609,599,10,0.0164203612479475
119.02,2020,Single Family - Detached,1254,1200,54,0.0430622009569378
119.02,2025,Mobile Home,0,0,0,
119.02,2025,Multifamily,466,457,9,0.01931330472103
119.02,2025,Single Family - Detached,1254,1204,50,0.0398724082934609
119.02,2030,Mobile Home,0,0,0,
119.02,2030,Multifamily,406,399,7,0.0172413793103448
119.02,2030,Single Family - Detached,1249,1199,50,0.0400320256204964
119.02,2035,Mobile Home,0,0,0,
119.02,2035,Multifamily,406,399,7,0.0172413793103448
119.02,2035,Single Family - Detached,1249,1200,49,0.0392313851080865
119.02,2040,Mobile Home,0,0,0,
119.02,2040,Multifamily,1391,1345,46,0.0330697340043134
119.02,2040,Single Family - Detached,1241,1193,48,0.0386784850926672
119.02,2045,Mobile Home,0,0,0,
119.02,2045,Multifamily,2064,2024,40,0.0193798449612403
119.02,2045,Single Family - Detached,1241,1191,50,0.040290088638195
119.02,2050,Mobile Home,0,0,0,
119.02,2050,Multifamily,2395,2352,43,0.0179540709812109
119.02,2050,Single Family - Detached,1241,1188,53,0.0427074939564867
12,2012,Mobile Home,0,0,0,
12,2012,Multifamily,2504,2413,91,0.0363418530351438
12,2012,Single Family - Detached,578,541,37,0.0640138408304498
12,2020,Mobile Home,0,0,0,
12,2020,Multifamily,2481,2374,107,0.0431277710600564
12,2020,Single Family - Detached,575,538,37,0.0643478260869565
12,2025,Mobile Home,0,0,0,
12,2025,Multifamily,2722,2633,89,0.0326965466568699
12,2025,Single Family - Detached,510,484,26,0.0509803921568627
12,2030,Mobile Home,0,0,0,
12,2030,Multifamily,2987,2918,69,0.0231001004352193
12,2030,Single Family - Detached,408,388,20,0.0490196078431373
12,2035,Mobile Home,0,0,0,
12,2035,Multifamily,3646,3598,48,0.0131651124520022
12,2035,Single Family - Detached,237,234,3,0.0126582278481013
12,2040,Mobile Home,0,0,0,
12,2040,Multifamily,4153,4102,51,0.012280279316157
12,2040,Single Family - Detached,132,126,6,0.0454545454545455
12,2045,Mobile Home,0,0,0,
12,2045,Multifamily,4159,4085,74,0.0177927386390959
12,2045,Single Family - Detached,132,116,16,0.121212121212121
12,2050,Mobile Home,0,0,0,
12,2050,Multifamily,4159,4039,120,0.0288530896850204
12,2050,Single Family - Detached,132,112,20,0.151515151515152
120.02,2012,Mobile Home,0,0,0,
120.02,2012,Multifamily,817,781,36,0.0440636474908201
120.02,2012,Single Family - Detached,376,332,44,0.117021276595745
120.02,2020,Mobile Home,0,0,0,
120.02,2020,Multifamily,817,780,37,0.0452876376988984
120.02,2020,Single Family - Detached,381,356,25,0.0656167979002625
120.02,2025,Mobile Home,0,0,0,
120.02,2025,Multifamily,817,781,36,0.0440636474908201
120.02,2025,Single Family - Detached,381,358,23,0.0603674540682415
120.02,2030,Mobile Home,0,0,0,
120.02,2030,Multifamily,817,781,36,0.0440636474908201
120.02,2030,Single Family - Detached,381,358,23,0.0603674540682415
120.02,2035,Mobile Home,0,0,0,
120.02,2035,Multifamily,721,689,32,0.0443828016643551
120.02,2035,Single Family - Detached,381,358,23,0.0603674540682415
120.02,2040,Mobile Home,0,0,0,
120.02,2040,Multifamily,529,513,16,0.0302457466918715
120.02,2040,Single Family - Detached,362,357,5,0.0138121546961326
120.02,2045,Mobile Home,0,0,0,
120.02,2045,Multifamily,529,509,20,0.0378071833648393
120.02,2045,Single Family - Detached,358,351,7,0.0195530726256983
120.02,2050,Mobile Home,0,0,0,
120.02,2050,Multifamily,540,515,25,0.0462962962962963
120.02,2050,Single Family - Detached,358,349,9,0.0251396648044693
120.03,2012,Mobile Home,0,0,0,
120.03,2012,Multifamily,112,109,3,0.0267857142857143
120.03,2012,Single Family - Detached,788,738,50,0.0634517766497462
120.03,2020,Mobile Home,0,0,0,
120.03,2020,Multifamily,112,108,4,0.0357142857142857
120.03,2020,Single Family - Detached,819,753,66,0.0805860805860806
120.03,2025,Mobile Home,0,0,0,
120.03,2025,Multifamily,112,109,3,0.0267857142857143
120.03,2025,Single Family - Detached,825,770,55,0.0666666666666667
120.03,2030,Mobile Home,0,0,0,
120.03,2030,Multifamily,112,109,3,0.0267857142857143
120.03,2030,Single Family - Detached,841,791,50,0.0594530321046373
120.03,2035,Mobile Home,0,0,0,
120.03,2035,Multifamily,112,109,3,0.0267857142857143
120.03,2035,Single Family - Detached,841,795,46,0.0546967895362663
120.03,2040,Mobile Home,0,0,0,
120.03,2040,Multifamily,112,105,7,0.0625
120.03,2040,Single Family - Detached,841,790,51,0.0606420927467301
120.03,2045,Mobile Home,0,0,0,
120.03,2045,Multifamily,57,50,7,0.12280701754386
120.03,2045,Single Family - Detached,761,712,49,0.064388961892247
120.03,2050,Mobile Home,0,0,0,
120.03,2050,Multifamily,57,47,10,0.175438596491228
120.03,2050,Single Family - Detached,736,678,58,0.078804347826087
121.01,2012,Mobile Home,0,0,0,
121.01,2012,Multifamily,249,242,7,0.0281124497991968
121.01,2012,Single Family - Detached,437,432,5,0.011441647597254
121.01,2020,Mobile Home,0,0,0,
121.01,2020,Multifamily,249,242,7,0.0281124497991968
121.01,2020,Single Family - Detached,438,416,22,0.0502283105022831
121.01,2025,Mobile Home,0,0,0,
121.01,2025,Multifamily,499,489,10,0.0200400801603206
121.01,2025,Single Family - Detached,438,426,12,0.0273972602739726
121.01,2030,Mobile Home,0,0,0,
121.01,2030,Multifamily,1419,1399,20,0.0140944326990839
121.01,2030,Single Family - Detached,438,426,12,0.0273972602739726
121.01,2035,Mobile Home,0,0,0,
121.01,2035,Multifamily,1419,1399,20,0.0140944326990839
121.01,2035,Single Family - Detached,438,427,11,0.0251141552511416
121.01,2040,Mobile Home,0,0,0,
121.01,2040,Multifamily,1419,1397,22,0.0155038759689922
121.01,2040,Single Family - Detached,438,417,21,0.0479452054794521
121.01,2045,Mobile Home,0,0,0,
121.01,2045,Multifamily,1346,1323,23,0.0170876671619614
121.01,2045,Single Family - Detached,429,405,24,0.0559440559440559
121.01,2050,Mobile Home,0,0,0,
121.01,2050,Multifamily,1340,1318,22,0.0164179104477612
121.01,2050,Single Family - Detached,446,411,35,0.07847533632287
121.02,2012,Mobile Home,0,0,0,
121.02,2012,Multifamily,220,209,11,0.05
121.02,2012,Single Family - Detached,689,672,17,0.0246734397677794
121.02,2020,Mobile Home,0,0,0,
121.02,2020,Multifamily,220,204,16,0.0727272727272727
121.02,2020,Single Family - Detached,689,658,31,0.0449927431059507
121.02,2025,Mobile Home,0,0,0,
121.02,2025,Multifamily,220,210,10,0.0454545454545455
121.02,2025,Single Family - Detached,689,661,28,0.0406386066763425
121.02,2030,Mobile Home,0,0,0,
121.02,2030,Multifamily,220,208,12,0.0545454545454545
121.02,2030,Single Family - Detached,689,660,29,0.0420899854862119
121.02,2035,Mobile Home,0,0,0,
121.02,2035,Multifamily,220,206,14,0.0636363636363636
121.02,2035,Single Family - Detached,689,661,28,0.0406386066763425
121.02,2040,Mobile Home,0,0,0,
121.02,2040,Multifamily,220,195,25,0.113636363636364
121.02,2040,Single Family - Detached,689,659,30,0.0435413642960813
121.02,2045,Mobile Home,0,0,0,
121.02,2045,Multifamily,220,183,37,0.168181818181818
121.02,2045,Single Family - Detached,689,658,31,0.0449927431059507
121.02,2050,Mobile Home,0,0,0,
121.02,2050,Multifamily,197,169,28,0.142131979695431
121.02,2050,Single Family - Detached,610,593,17,0.0278688524590164
122,2012,Mobile Home,206,182,24,0.116504854368932
122,2012,Multifamily,15,12,3,0.2
122,2012,Single Family - Detached,715,712,3,0.0041958041958042
122,2020,Mobile Home,206,183,23,0.111650485436893
122,2020,Multifamily,658,627,31,0.047112462006079
122,2020,Single Family - Detached,730,699,31,0.0424657534246575
122,2025,Mobile Home,206,183,23,0.111650485436893
122,2025,Multifamily,658,632,26,0.0395136778115502
122,2025,Single Family - Detached,731,716,15,0.0205198358413133
122,2030,Mobile Home,206,182,24,0.116504854368932
122,2030,Multifamily,658,627,31,0.047112462006079
122,2030,Single Family - Detached,734,717,17,0.0231607629427793
122,2035,Mobile Home,206,182,24,0.116504854368932
122,2035,Multifamily,658,625,33,0.0501519756838906
122,2035,Single Family - Detached,734,722,12,0.0163487738419619
122,2040,Mobile Home,206,182,24,0.116504854368932
122,2040,Multifamily,658,619,39,0.0592705167173252
122,2040,Single Family - Detached,734,709,25,0.0340599455040872
122,2045,Mobile Home,206,181,25,0.121359223300971
122,2045,Multifamily,658,613,45,0.0683890577507599
122,2045,Single Family - Detached,734,697,37,0.050408719346049
122,2050,Mobile Home,206,177,29,0.140776699029126
122,2050,Multifamily,658,611,47,0.0714285714285714
122,2050,Single Family - Detached,877,840,37,0.0421892816419612
123.02,2012,Mobile Home,0,0,0,
123.02,2012,Multifamily,584,581,3,0.00513698630136986
123.02,2012,Single Family - Detached,149,152,-3,-0.0201342281879195
123.02,2020,Mobile Home,0,0,0,
123.02,2020,Multifamily,584,584,0,0
123.02,2020,Single Family - Detached,149,149,0,0
123.02,2025,Mobile Home,0,0,0,
123.02,2025,Multifamily,585,585,0,0
123.02,2025,Single Family - Detached,149,149,0,0
123.02,2030,Mobile Home,0,0,0,
123.02,2030,Multifamily,703,694,9,0.0128022759601707
123.02,2030,Single Family - Detached,101,101,0,0
123.02,2035,Mobile Home,0,0,0,
123.02,2035,Multifamily,1589,1552,37,0.0232850849590938
123.02,2035,Single Family - Detached,45,45,0,0
123.02,2040,Mobile Home,0,0,0,
123.02,2040,Multifamily,1572,1535,37,0.0235368956743003
123.02,2040,Single Family - Detached,45,40,5,0.111111111111111
123.02,2045,Mobile Home,0,0,0,
123.02,2045,Multifamily,1572,1533,39,0.0248091603053435
123.02,2045,Single Family - Detached,45,37,8,0.177777777777778
123.02,2050,Mobile Home,0,0,0,
123.02,2050,Multifamily,1572,1533,39,0.0248091603053435
123.02,2050,Single Family - Detached,45,37,8,0.177777777777778
123.03,2012,Mobile Home,0,0,0,
123.03,2012,Multifamily,834,762,72,0.0863309352517986
123.03,2012,Single Family - Detached,694,630,64,0.0922190201729107
123.03,2020,Mobile Home,0,0,0,
123.03,2020,Multifamily,834,763,71,0.0851318944844125
123.03,2020,Single Family - Detached,694,627,67,0.0965417867435159
123.03,2025,Mobile Home,0,0,0,
123.03,2025,Multifamily,834,768,66,0.079136690647482
123.03,2025,Single Family - Detached,694,629,65,0.0936599423631124
123.03,2030,Mobile Home,0,0,0,
123.03,2030,Multifamily,834,764,70,0.0839328537170264
123.03,2030,Single Family - Detached,694,629,65,0.0936599423631124
123.03,2035,Mobile Home,0,0,0,
123.03,2035,Multifamily,870,793,77,0.0885057471264368
123.03,2035,Single Family - Detached,694,634,60,0.0864553314121038
123.03,2040,Mobile Home,0,0,0,
123.03,2040,Multifamily,870,789,81,0.0931034482758621
123.03,2040,Single Family - Detached,707,690,17,0.024045261669024
123.03,2045,Mobile Home,0,0,0,
123.03,2045,Multifamily,870,785,85,0.0977011494252874
123.03,2045,Single Family - Detached,707,687,20,0.0282885431400283
123.03,2050,Mobile Home,0,0,0,
123.03,2050,Multifamily,870,782,88,0.101149425287356
123.03,2050,Single Family - Detached,707,686,21,0.0297029702970297
123.04,2012,Mobile Home,0,0,0,
123.04,2012,Multifamily,462,419,43,0.0930735930735931
123.04,2012,Single Family - Detached,949,942,7,0.00737618545837724
123.04,2020,Mobile Home,0,0,0,
123.04,2020,Multifamily,462,419,43,0.0930735930735931
123.04,2020,Single Family - Detached,952,948,4,0.00420168067226891
123.04,2025,Mobile Home,0,0,0,
123.04,2025,Multifamily,462,424,38,0.0822510822510823
123.04,2025,Single Family - Detached,952,948,4,0.00420168067226891
123.04,2030,Mobile Home,0,0,0,
123.04,2030,Multifamily,595,549,46,0.0773109243697479
123.04,2030,Single Family - Detached,901,898,3,0.00332963374028857
123.04,2035,Mobile Home,0,0,0,
123.04,2035,Multifamily,648,632,16,0.0246913580246914
123.04,2035,Single Family - Detached,880,880,0,0
123.04,2040,Mobile Home,0,0,0,
123.04,2040,Multifamily,648,626,22,0.0339506172839506
123.04,2040,Single Family - Detached,899,877,22,0.0244716351501669
123.04,2045,Mobile Home,0,0,0,
123.04,2045,Multifamily,648,621,27,0.0416666666666667
123.04,2045,Single Family - Detached,899,875,24,0.0266963292547275
123.04,2050,Mobile Home,0,0,0,
123.04,2050,Multifamily,648,620,28,0.0432098765432099
123.04,2050,Single Family - Detached,899,874,25,0.0278086763070078
124.01,2012,Mobile Home,166,166,0,0
124.01,2012,Multifamily,859,857,2,0.00232828870779977
124.01,2012,Single Family - Detached,332,334,-2,-0.00602409638554217
124.01,2020,Mobile Home,166,166,0,0
124.01,2020,Multifamily,859,858,1,0.00116414435389988
124.01,2020,Single Family - Detached,333,331,2,0.00600600600600601
124.01,2025,Mobile Home,166,166,0,0
124.01,2025,Multifamily,859,859,0,0
124.01,2025,Single Family - Detached,333,332,1,0.003003003003003
124.01,2030,Mobile Home,166,165,1,0.00602409638554217
124.01,2030,Multifamily,859,854,5,0.00582072176949942
124.01,2030,Single Family - Detached,333,332,1,0.003003003003003
124.01,2035,Mobile Home,166,161,5,0.0301204819277108
124.01,2035,Multifamily,983,969,14,0.0142421159715158
124.01,2035,Single Family - Detached,323,324,-1,-0.00309597523219814
124.01,2040,Mobile Home,166,161,5,0.0301204819277108
124.01,2040,Multifamily,983,966,17,0.017293997965412
124.01,2040,Single Family - Detached,340,329,11,0.0323529411764706
124.01,2045,Mobile Home,166,159,7,0.0421686746987952
124.01,2045,Multifamily,983,963,20,0.0203458799593082
124.01,2045,Single Family - Detached,340,328,12,0.0352941176470588
124.01,2050,Mobile Home,166,156,10,0.0602409638554217
124.01,2050,Multifamily,983,961,22,0.0223804679552391
124.01,2050,Single Family - Detached,340,327,13,0.0382352941176471
124.02,2012,Mobile Home,0,0,0,
124.02,2012,Multifamily,1179,1141,38,0.0322307039864292
124.02,2012,Single Family - Detached,839,813,26,0.0309892729439809
124.02,2020,Mobile Home,0,0,0,
124.02,2020,Multifamily,1179,1142,37,0.0313825275657337
124.02,2020,Single Family - Detached,840,812,28,0.0333333333333333
124.02,2025,Mobile Home,0,0,0,
124.02,2025,Multifamily,1179,1147,32,0.0271416454622561
124.02,2025,Single Family - Detached,840,812,28,0.0333333333333333
124.02,2030,Mobile Home,0,0,0,
124.02,2030,Multifamily,1179,1139,40,0.0339270568278202
124.02,2030,Single Family - Detached,840,812,28,0.0333333333333333
124.02,2035,Mobile Home,0,0,0,
124.02,2035,Multifamily,1572,1511,61,0.0388040712468193
124.02,2035,Single Family - Detached,734,710,24,0.0326975476839237
124.02,2040,Mobile Home,0,0,0,
124.02,2040,Multifamily,1572,1505,67,0.0426208651399491
124.02,2040,Single Family - Detached,736,694,42,0.0570652173913043
124.02,2045,Mobile Home,0,0,0,
124.02,2045,Multifamily,1572,1499,73,0.0464376590330789
124.02,2045,Single Family - Detached,734,691,43,0.05858310626703
124.02,2050,Mobile Home,0,0,0,
124.02,2050,Multifamily,1572,1497,75,0.0477099236641221
124.02,2050,Single Family - Detached,735,692,43,0.0585034013605442
125.01,2012,Mobile Home,601,564,37,0.0615640599001664
125.01,2012,Multifamily,963,915,48,0.0498442367601246
125.01,2012,Single Family - Detached,14,14,0,0
125.01,2020,Mobile Home,493,448,45,0.0912778904665314
125.01,2020,Multifamily,958,900,58,0.0605427974947808
125.01,2020,Single Family - Detached,14,9,5,0.357142857142857
125.01,2025,Mobile Home,462,428,34,0.0735930735930736
125.01,2025,Multifamily,849,838,11,0.0129564193168433
125.01,2025,Single Family - Detached,14,14,0,0
125.01,2030,Mobile Home,462,426,36,0.0779220779220779
125.01,2030,Multifamily,849,833,16,0.0188457008244994
125.01,2030,Single Family - Detached,14,13,1,0.0714285714285714
125.01,2035,Mobile Home,280,270,10,0.0357142857142857
125.01,2035,Multifamily,1397,1370,27,0.01932712956335
125.01,2035,Single Family - Detached,11,11,0,0
125.01,2040,Mobile Home,280,254,26,0.0928571428571429
125.01,2040,Multifamily,1892,1845,47,0.0248414376321353
125.01,2040,Single Family - Detached,2,1,1,0.5
125.01,2045,Mobile Home,30,21,9,0.3
125.01,2045,Multifamily,2506,2428,78,0.0311252992817239
125.01,2045,Single Family - Detached,0,0,0,
125.01,2050,Mobile Home,30,25,5,0.166666666666667
125.01,2050,Multifamily,2666,2586,80,0.0300075018754689
125.01,2050,Single Family - Detached,0,0,0,
125.02,2012,Mobile Home,448,389,59,0.131696428571429
125.02,2012,Multifamily,940,868,72,0.0765957446808511
125.02,2012,Single Family - Detached,305,301,4,0.0131147540983607
125.02,2020,Mobile Home,308,293,15,0.0487012987012987
125.02,2020,Multifamily,944,922,22,0.0233050847457627
125.02,2020,Single Family - Detached,306,300,6,0.0196078431372549
125.02,2025,Mobile Home,308,291,17,0.0551948051948052
125.02,2025,Multifamily,944,916,28,0.0296610169491525
125.02,2025,Single Family - Detached,306,302,4,0.0130718954248366
125.02,2030,Mobile Home,308,290,18,0.0584415584415584
125.02,2030,Multifamily,1156,1124,32,0.027681660899654
125.02,2030,Single Family - Detached,269,265,4,0.0148698884758364
125.02,2035,Mobile Home,279,270,9,0.032258064516129
125.02,2035,Multifamily,1457,1420,37,0.0253946465339739
125.02,2035,Single Family - Detached,251,248,3,0.0119521912350598
125.02,2040,Mobile Home,153,147,6,0.0392156862745098
125.02,2040,Multifamily,1926,1844,82,0.0425752855659398
125.02,2040,Single Family - Detached,251,247,4,0.0159362549800797
125.02,2045,Mobile Home,98,95,3,0.0306122448979592
125.02,2045,Multifamily,2106,2029,77,0.0365622032288699
125.02,2045,Single Family - Detached,253,248,5,0.0197628458498024
125.02,2050,Mobile Home,97,92,5,0.0515463917525773
125.02,2050,Multifamily,2108,2021,87,0.0412713472485769
125.02,2050,Single Family - Detached,255,249,6,0.0235294117647059
126,2012,Mobile Home,156,101,55,0.352564102564103
126,2012,Multifamily,478,386,92,0.192468619246862
126,2012,Single Family - Detached,1106,1083,23,0.0207956600361664
126,2020,Mobile Home,156,97,59,0.378205128205128
126,2020,Multifamily,478,373,105,0.219665271966527
126,2020,Single Family - Detached,1106,1079,27,0.0244122965641953
126,2025,Mobile Home,156,93,63,0.403846153846154
126,2025,Multifamily,470,364,106,0.225531914893617
126,2025,Single Family - Detached,1089,1065,24,0.0220385674931129
126,2030,Mobile Home,156,91,65,0.416666666666667
126,2030,Multifamily,470,358,112,0.238297872340426
126,2030,Single Family - Detached,1089,1065,24,0.0220385674931129
126,2035,Mobile Home,156,96,60,0.384615384615385
126,2035,Multifamily,466,356,110,0.236051502145923
126,2035,Single Family - Detached,1023,1000,23,0.0224828934506354
126,2040,Mobile Home,101,82,19,0.188118811881188
126,2040,Multifamily,498,464,34,0.0682730923694779
126,2040,Single Family - Detached,1013,999,14,0.0138203356367226
126,2045,Mobile Home,46,46,0,0
126,2045,Multifamily,427,397,30,0.0702576112412178
126,2045,Single Family - Detached,990,977,13,0.0131313131313131
126,2050,Mobile Home,0,0,0,
126,2050,Multifamily,924,885,39,0.0422077922077922
126,2050,Single Family - Detached,975,963,12,0.0123076923076923
127,2012,Mobile Home,0,0,0,
127,2012,Multifamily,1250,1225,25,0.02
127,2012,Single Family - Detached,682,644,38,0.0557184750733138
127,2020,Mobile Home,0,0,0,
127,2020,Multifamily,1168,1132,36,0.0308219178082192
127,2020,Single Family - Detached,630,610,20,0.0317460317460317
127,2025,Mobile Home,0,0,0,
127,2025,Multifamily,1472,1427,45,0.030570652173913
127,2025,Single Family - Detached,590,575,15,0.0254237288135593
127,2030,Mobile Home,0,0,0,
127,2030,Multifamily,2030,1969,61,0.0300492610837438
127,2030,Single Family - Detached,568,554,14,0.0246478873239437
127,2035,Mobile Home,0,0,0,
127,2035,Multifamily,2213,2144,69,0.0311793944871216
127,2035,Single Family - Detached,548,536,12,0.0218978102189781
127,2040,Mobile Home,0,0,0,
127,2040,Multifamily,2618,2488,130,0.0496562261268144
127,2040,Single Family - Detached,548,530,18,0.0328467153284672
127,2045,Mobile Home,0,0,0,
127,2045,Multifamily,2620,2475,145,0.0553435114503817
127,2045,Single Family - Detached,548,526,22,0.0401459854014599
127,2050,Mobile Home,0,0,0,
127,2050,Multifamily,2624,2467,157,0.0598323170731707
127,2050,Single Family - Detached,548,524,24,0.0437956204379562
128,2012,Mobile Home,0,0,0,
128,2012,Multifamily,491,475,16,0.0325865580448065
128,2012,Single Family - Detached,932,913,19,0.0203862660944206
128,2020,Mobile Home,0,0,0,
128,2020,Multifamily,674,655,19,0.0281899109792285
128,2020,Single Family - Detached,913,893,20,0.0219058050383352
128,2025,Mobile Home,0,0,0,
128,2025,Multifamily,836,814,22,0.0263157894736842
128,2025,Single Family - Detached,906,889,17,0.0187637969094923
128,2030,Mobile Home,0,0,0,
128,2030,Multifamily,907,881,26,0.0286659316427784
128,2030,Single Family - Detached,907,890,17,0.0187431091510474
128,2035,Mobile Home,0,0,0,
128,2035,Multifamily,916,890,26,0.0283842794759825
128,2035,Single Family - Detached,907,892,15,0.0165380374862183
128,2040,Mobile Home,0,0,0,
128,2040,Multifamily,917,871,46,0.0501635768811341
128,2040,Single Family - Detached,909,890,19,0.0209020902090209
128,2045,Mobile Home,0,0,0,
128,2045,Multifamily,917,864,53,0.0577971646673937
128,2045,Single Family - Detached,909,887,22,0.0242024202420242
128,2050,Mobile Home,0,0,0,
128,2050,Multifamily,917,858,59,0.064340239912759
128,2050,Single Family - Detached,909,886,23,0.0253025302530253
129,2012,Mobile Home,0,0,0,
129,2012,Multifamily,115,114,1,0.00869565217391304
129,2012,Single Family - Detached,1039,1004,35,0.0336862367661213
129,2020,Mobile Home,0,0,0,
129,2020,Multifamily,115,112,3,0.0260869565217391
129,2020,Single Family - Detached,1042,1004,38,0.036468330134357
129,2025,Mobile Home,0,0,0,
129,2025,Multifamily,115,111,4,0.0347826086956522
129,2025,Single Family - Detached,1042,1006,36,0.0345489443378119
129,2030,Mobile Home,0,0,0,
129,2030,Multifamily,115,109,6,0.0521739130434783
129,2030,Single Family - Detached,1042,1004,38,0.036468330134357
129,2035,Mobile Home,0,0,0,
129,2035,Multifamily,115,108,7,0.0608695652173913
129,2035,Single Family - Detached,1042,1006,36,0.0345489443378119
129,2040,Mobile Home,0,0,0,
129,2040,Multifamily,115,105,10,0.0869565217391304
129,2040,Single Family - Detached,1046,1006,40,0.0382409177820268
129,2045,Mobile Home,0,0,0,
129,2045,Multifamily,115,104,11,0.0956521739130435
129,2045,Single Family - Detached,1046,1005,41,0.0391969407265774
129,2050,Mobile Home,0,0,0,
129,2050,Multifamily,115,103,12,0.104347826086957
129,2050,Single Family - Detached,1046,1005,41,0.0391969407265774
13,2012,Mobile Home,0,0,0,
13,2012,Multifamily,2869,2803,66,0.0230045311955385
13,2012,Single Family - Detached,552,540,12,0.0217391304347826
13,2020,Mobile Home,0,0,0,
13,2020,Multifamily,2869,2781,88,0.030672708260718
13,2020,Single Family - Detached,554,534,20,0.036101083032491
13,2025,Mobile Home,0,0,0,
13,2025,Multifamily,2869,2783,86,0.0299756012547926
13,2025,Single Family - Detached,554,543,11,0.01985559566787
13,2030,Mobile Home,0,0,0,
13,2030,Multifamily,2869,2770,99,0.0345067967933078
13,2030,Single Family - Detached,554,541,13,0.0234657039711191
13,2035,Mobile Home,0,0,0,
13,2035,Multifamily,2873,2775,98,0.0341106856943961
13,2035,Single Family - Detached,554,542,12,0.0216606498194946
13,2040,Mobile Home,0,0,0,
13,2040,Multifamily,3229,3115,114,0.0353050480024775
13,2040,Single Family - Detached,505,492,13,0.0257425742574257
13,2045,Mobile Home,0,0,0,
13,2045,Multifamily,3764,3659,105,0.0278958554729012
13,2045,Single Family - Detached,299,281,18,0.0602006688963211
13,2050,Mobile Home,0,0,0,
13,2050,Multifamily,5138,5024,114,0.0221876216426625
13,2050,Single Family - Detached,77,67,10,0.12987012987013
130,2012,Mobile Home,0,0,0,
130,2012,Multifamily,796,795,1,0.00125628140703518
130,2012,Single Family - Detached,1101,1087,14,0.0127157129881926
130,2020,Mobile Home,0,0,0,
130,2020,Multifamily,779,756,23,0.0295250320924262
130,2020,Single Family - Detached,1102,1075,27,0.0245009074410163
130,2025,Mobile Home,0,0,0,
130,2025,Multifamily,779,747,32,0.0410783055198973
130,2025,Single Family - Detached,1101,1076,25,0.0227066303360581
130,2030,Mobile Home,0,0,0,
130,2030,Multifamily,788,749,39,0.049492385786802
130,2030,Single Family - Detached,1098,1074,24,0.0218579234972678
130,2035,Mobile Home,0,0,0,
130,2035,Multifamily,788,741,47,0.0596446700507614
130,2035,Single Family - Detached,1098,1075,23,0.0209471766848816
130,2040,Mobile Home,0,0,0,
130,2040,Multifamily,780,711,69,0.0884615384615385
130,2040,Single Family - Detached,1098,1072,26,0.0236794171220401
130,2045,Mobile Home,0,0,0,
130,2045,Multifamily,804,724,80,0.0995024875621891
130,2045,Single Family - Detached,1098,1070,28,0.0255009107468124
130,2050,Mobile Home,0,0,0,
130,2050,Multifamily,959,861,98,0.102189781021898
130,2050,Single Family - Detached,1101,1074,27,0.0245231607629428
131.02,2012,Mobile Home,147,147,0,0
131.02,2012,Multifamily,1264,1218,46,0.0363924050632911
131.02,2012,Single Family - Detached,839,817,22,0.0262216924910608
131.02,2020,Mobile Home,16,16,0,0
131.02,2020,Multifamily,1306,1262,44,0.0336906584992343
131.02,2020,Single Family - Detached,809,791,18,0.0222496909765142
131.02,2025,Mobile Home,16,15,1,0.0625
131.02,2025,Multifamily,1480,1439,41,0.0277027027027027
131.02,2025,Single Family - Detached,803,787,16,0.0199252801992528
131.02,2030,Mobile Home,16,14,2,0.125
131.02,2030,Multifamily,1736,1690,46,0.0264976958525346
131.02,2030,Single Family - Detached,801,785,16,0.0199750312109863
131.02,2035,Mobile Home,16,15,1,0.0625
131.02,2035,Multifamily,1864,1848,16,0.00858369098712446
131.02,2035,Single Family - Detached,789,776,13,0.0164765525982256
131.02,2040,Mobile Home,0,0,0,
131.02,2040,Multifamily,2025,2004,21,0.0103703703703704
131.02,2040,Single Family - Detached,779,765,14,0.0179717586649551
131.02,2045,Mobile Home,0,0,0,
131.02,2045,Multifamily,2038,2016,22,0.0107948969578018
131.02,2045,Single Family - Detached,779,764,15,0.0192554557124519
131.02,2050,Mobile Home,0,0,0,
131.02,2050,Multifamily,2038,2016,22,0.0107948969578018
131.02,2050,Single Family - Detached,779,758,21,0.0269576379974326
131.03,2012,Mobile Home,245,245,0,0
131.03,2012,Multifamily,311,288,23,0.0739549839228296
131.03,2012,Single Family - Detached,240,237,3,0.0125
131.03,2020,Mobile Home,245,245,0,0
131.03,2020,Multifamily,311,288,23,0.0739549839228296
131.03,2020,Single Family - Detached,245,242,3,0.0122448979591837
131.03,2025,Mobile Home,245,245,0,0
131.03,2025,Multifamily,311,289,22,0.0707395498392283
131.03,2025,Single Family - Detached,245,243,2,0.00816326530612245
131.03,2030,Mobile Home,245,245,0,0
131.03,2030,Multifamily,311,289,22,0.0707395498392283
131.03,2030,Single Family - Detached,245,243,2,0.00816326530612245
131.03,2035,Mobile Home,245,245,0,0
131.03,2035,Multifamily,300,295,5,0.0166666666666667
131.03,2035,Single Family - Detached,244,242,2,0.00819672131147541
131.03,2040,Mobile Home,245,245,0,0
131.03,2040,Multifamily,711,699,12,0.0168776371308017
131.03,2040,Single Family - Detached,244,242,2,0.00819672131147541
131.03,2045,Mobile Home,245,245,0,0
131.03,2045,Multifamily,1130,1116,14,0.0123893805309735
131.03,2045,Single Family - Detached,210,208,2,0.00952380952380952
131.03,2050,Mobile Home,245,243,2,0.00816326530612245
131.03,2050,Multifamily,1145,1130,15,0.0131004366812227
131.03,2050,Single Family - Detached,211,209,2,0.00947867298578199
131.04,2012,Mobile Home,0,0,0,
131.04,2012,Multifamily,1369,1362,7,0.00511322132943755
131.04,2012,Single Family - Detached,569,554,15,0.0263620386643234
131.04,2020,Mobile Home,0,0,0,
131.04,2020,Multifamily,1369,1362,7,0.00511322132943755
131.04,2020,Single Family - Detached,579,568,11,0.0189982728842832
131.04,2025,Mobile Home,0,0,0,
131.04,2025,Multifamily,1369,1364,5,0.00365230094959825
131.04,2025,Single Family - Detached,579,569,10,0.0172711571675302
131.04,2030,Mobile Home,0,0,0,
131.04,2030,Multifamily,1362,1357,5,0.00367107195301028
131.04,2030,Single Family - Detached,579,569,10,0.0172711571675302
131.04,2035,Mobile Home,0,0,0,
131.04,2035,Multifamily,1395,1384,11,0.00788530465949821
131.04,2035,Single Family - Detached,570,562,8,0.0140350877192982
131.04,2040,Mobile Home,0,0,0,
131.04,2040,Multifamily,1551,1540,11,0.00709219858156028
131.04,2040,Single Family - Detached,567,560,7,0.0123456790123457
131.04,2045,Mobile Home,0,0,0,
131.04,2045,Multifamily,1554,1541,13,0.00836550836550837
131.04,2045,Single Family - Detached,567,560,7,0.0123456790123457
131.04,2050,Mobile Home,0,0,0,
131.04,2050,Multifamily,1554,1541,13,0.00836550836550837
131.04,2050,Single Family - Detached,567,557,10,0.017636684303351
132.03,2012,Mobile Home,0,0,0,
132.03,2012,Multifamily,1703,1698,5,0.00293599530240752
132.03,2012,Single Family - Detached,463,459,4,0.00863930885529158
132.03,2020,Mobile Home,0,0,0,
132.03,2020,Multifamily,1660,1654,6,0.0036144578313253
132.03,2020,Single Family - Detached,455,445,10,0.021978021978022
132.03,2025,Mobile Home,0,0,0,
132.03,2025,Multifamily,1638,1634,4,0.00244200244200244
132.03,2025,Single Family - Detached,454,448,6,0.013215859030837
132.03,2030,Mobile Home,0,0,0,
132.03,2030,Multifamily,1643,1639,4,0.00243457090687766
132.03,2030,Single Family - Detached,451,445,6,0.0133037694013304
132.03,2035,Mobile Home,0,0,0,
132.03,2035,Multifamily,1655,1640,15,0.00906344410876133
132.03,2035,Single Family - Detached,450,445,5,0.0111111111111111
132.03,2040,Mobile Home,0,0,0,
132.03,2040,Multifamily,1976,1950,26,0.0131578947368421
132.03,2040,Single Family - Detached,435,429,6,0.0137931034482759
132.03,2045,Mobile Home,0,0,0,
132.03,2045,Multifamily,1984,1957,27,0.0136088709677419
132.03,2045,Single Family - Detached,435,427,8,0.0183908045977011
132.03,2050,Mobile Home,0,0,0,
132.03,2050,Multifamily,1984,1953,31,0.015625
132.03,2050,Single Family - Detached,436,425,11,0.0252293577981651
132.04,2012,Mobile Home,439,422,17,0.0387243735763098
132.04,2012,Multifamily,246,244,2,0.00813008130081301
132.04,2012,Single Family - Detached,456,458,-2,-0.0043859649122807
132.04,2020,Mobile Home,439,425,14,0.0318906605922551
132.04,2020,Multifamily,246,244,2,0.00813008130081301
132.04,2020,Single Family - Detached,459,459,0,0
132.04,2025,Mobile Home,439,425,14,0.0318906605922551
132.04,2025,Multifamily,246,246,0,0
132.04,2025,Single Family - Detached,459,460,-1,-0.00217864923747277
132.04,2030,Mobile Home,439,423,16,0.0364464692482916
132.04,2030,Multifamily,246,246,0,0
132.04,2030,Single Family - Detached,459,460,-1,-0.00217864923747277
132.04,2035,Mobile Home,439,423,16,0.0364464692482916
132.04,2035,Multifamily,246,240,6,0.024390243902439
132.04,2035,Single Family - Detached,419,420,-1,-0.00238663484486874
132.04,2040,Mobile Home,439,423,16,0.0364464692482916
132.04,2040,Multifamily,246,236,10,0.040650406504065
132.04,2040,Single Family - Detached,413,414,-1,-0.00242130750605327
132.04,2045,Mobile Home,439,421,18,0.041002277904328
132.04,2045,Multifamily,242,230,12,0.0495867768595041
132.04,2045,Single Family - Detached,395,396,-1,-0.00253164556962025
132.04,2050,Mobile Home,439,412,27,0.061503416856492
132.04,2050,Multifamily,242,226,16,0.0661157024793388
132.04,2050,Single Family - Detached,396,395,1,0.00252525252525253
132.05,2012,Mobile Home,211,205,6,0.028436018957346
132.05,2012,Multifamily,293,268,25,0.0853242320819113
132.05,2012,Single Family - Detached,185,187,-2,-0.0108108108108108
132.05,2020,Mobile Home,211,207,4,0.018957345971564
132.05,2020,Multifamily,293,267,26,0.0887372013651877
132.05,2020,Single Family - Detached,193,189,4,0.0207253886010363
132.05,2025,Mobile Home,211,206,5,0.023696682464455
132.05,2025,Multifamily,293,270,23,0.0784982935153584
132.05,2025,Single Family - Detached,193,192,1,0.00518134715025907
132.05,2030,Mobile Home,211,204,7,0.033175355450237
132.05,2030,Multifamily,293,270,23,0.0784982935153584
132.05,2030,Single Family - Detached,193,191,2,0.0103626943005181
132.05,2035,Mobile Home,211,205,6,0.028436018957346
132.05,2035,Multifamily,293,265,28,0.0955631399317406
132.05,2035,Single Family - Detached,193,192,1,0.00518134715025907
132.05,2040,Mobile Home,211,207,4,0.018957345971564
132.05,2040,Multifamily,293,259,34,0.116040955631399
132.05,2040,Single Family - Detached,193,189,4,0.0207253886010363
132.05,2045,Mobile Home,169,165,4,0.0236686390532544
132.05,2045,Multifamily,490,450,40,0.0816326530612245
132.05,2045,Single Family - Detached,193,187,6,0.0310880829015544
132.05,2050,Mobile Home,142,137,5,0.0352112676056338
132.05,2050,Multifamily,1280,1229,51,0.03984375
132.05,2050,Single Family - Detached,117,110,7,0.0598290598290598
132.06,2012,Mobile Home,724,722,2,0.00276243093922652
132.06,2012,Multifamily,1248,1246,2,0.0016025641025641
132.06,2012,Single Family - Detached,437,419,18,0.0411899313501144
132.06,2020,Mobile Home,724,724,0,0
132.06,2020,Multifamily,1248,1246,2,0.0016025641025641
132.06,2020,Single Family - Detached,437,412,25,0.05720823798627
132.06,2025,Mobile Home,724,724,0,0
132.06,2025,Multifamily,1248,1248,0,0
132.06,2025,Single Family - Detached,437,417,20,0.045766590389016
132.06,2030,Mobile Home,724,720,4,0.00552486187845304
132.06,2030,Multifamily,1248,1248,0,0
132.06,2030,Single Family - Detached,437,417,20,0.045766590389016
132.06,2035,Mobile Home,724,720,4,0.00552486187845304
132.06,2035,Multifamily,1248,1240,8,0.00641025641025641
132.06,2035,Single Family - Detached,436,416,20,0.0458715596330275
132.06,2040,Mobile Home,724,723,1,0.00138121546961326
132.06,2040,Multifamily,1305,1294,11,0.00842911877394636
132.06,2040,Single Family - Detached,425,402,23,0.0541176470588235
132.06,2045,Mobile Home,724,718,6,0.00828729281767956
132.06,2045,Multifamily,1236,1221,15,0.0121359223300971
132.06,2045,Single Family - Detached,425,400,25,0.0588235294117647
132.06,2050,Mobile Home,724,701,23,0.031767955801105
132.06,2050,Multifamily,1256,1239,17,0.0135350318471338
132.06,2050,Single Family - Detached,396,386,10,0.0252525252525253
133.01,2012,Mobile Home,0,0,0,
133.01,2012,Multifamily,142,142,0,0
133.01,2012,Single Family - Detached,1395,1348,47,0.0336917562724014
133.01,2020,Mobile Home,0,0,0,
133.01,2020,Multifamily,142,142,0,0
133.01,2020,Single Family - Detached,1396,1348,48,0.0343839541547278
133.01,2025,Mobile Home,0,0,0,
133.01,2025,Multifamily,142,136,6,0.0422535211267606
133.01,2025,Single Family - Detached,1396,1349,47,0.0336676217765043
133.01,2030,Mobile Home,0,0,0,
133.01,2030,Multifamily,142,136,6,0.0422535211267606
133.01,2030,Single Family - Detached,1396,1349,47,0.0336676217765043
133.01,2035,Mobile Home,0,0,0,
133.01,2035,Multifamily,142,136,6,0.0422535211267606
133.01,2035,Single Family - Detached,1396,1349,47,0.0336676217765043
133.01,2040,Mobile Home,0,0,0,
133.01,2040,Multifamily,142,134,8,0.0563380281690141
133.01,2040,Single Family - Detached,1399,1351,48,0.0343102215868477
133.01,2045,Mobile Home,0,0,0,
133.01,2045,Multifamily,142,134,8,0.0563380281690141
133.01,2045,Single Family - Detached,1399,1349,50,0.0357398141529664
133.01,2050,Mobile Home,0,0,0,
133.01,2050,Multifamily,142,134,8,0.0563380281690141
133.01,2050,Single Family - Detached,1399,1349,50,0.0357398141529664
133.02,2012,Mobile Home,0,0,0,
133.02,2012,Multifamily,0,0,0,
133.02,2012,Single Family - Detached,1345,1325,20,0.0148698884758364
133.02,2020,Mobile Home,0,0,0,
133.02,2020,Multifamily,0,0,0,
133.02,2020,Single Family - Detached,1348,1331,17,0.0126112759643917
133.02,2025,Mobile Home,0,0,0,
133.02,2025,Multifamily,0,0,0,
133.02,2025,Single Family - Detached,1348,1332,16,0.0118694362017804
133.02,2030,Mobile Home,0,0,0,
133.02,2030,Multifamily,0,0,0,
133.02,2030,Single Family - Detached,1348,1332,16,0.0118694362017804
133.02,2035,Mobile Home,0,0,0,
133.02,2035,Multifamily,0,0,0,
133.02,2035,Single Family - Detached,1348,1332,16,0.0118694362017804
133.02,2040,Mobile Home,0,0,0,
133.02,2040,Multifamily,0,0,0,
133.02,2040,Single Family - Detached,1348,1331,17,0.0126112759643917
133.02,2045,Mobile Home,0,0,0,
133.02,2045,Multifamily,0,0,0,
133.02,2045,Single Family - Detached,1350,1331,19,0.0140740740740741
133.02,2050,Mobile Home,0,0,0,
133.02,2050,Multifamily,0,0,0,
133.02,2050,Single Family - Detached,1350,1331,19,0.0140740740740741
133.03,2012,Mobile Home,290,279,11,0.0379310344827586
133.03,2012,Multifamily,236,236,0,0
133.03,2012,Single Family - Detached,963,955,8,0.0083073727933541
133.03,2020,Mobile Home,290,280,10,0.0344827586206897
133.03,2020,Multifamily,236,236,0,0
133.03,2020,Single Family - Detached,964,950,14,0.0145228215767635
133.03,2025,Mobile Home,290,280,10,0.0344827586206897
133.03,2025,Multifamily,236,225,11,0.0466101694915254
133.03,2025,Single Family - Detached,964,952,12,0.012448132780083
133.03,2030,Mobile Home,290,278,12,0.0413793103448276
133.03,2030,Multifamily,236,223,13,0.0550847457627119
133.03,2030,Single Family - Detached,964,951,13,0.0134854771784232
133.03,2035,Mobile Home,290,278,12,0.0413793103448276
133.03,2035,Multifamily,236,223,13,0.0550847457627119
133.03,2035,Single Family - Detached,964,954,10,0.0103734439834025
133.03,2040,Mobile Home,290,279,11,0.0379310344827586
133.03,2040,Multifamily,236,220,16,0.0677966101694915
133.03,2040,Single Family - Detached,964,952,12,0.012448132780083
133.03,2045,Mobile Home,290,278,12,0.0413793103448276
133.03,2045,Multifamily,236,219,17,0.0720338983050847
133.03,2045,Single Family - Detached,965,945,20,0.0207253886010363
133.03,2050,Mobile Home,290,272,18,0.0620689655172414
133.03,2050,Multifamily,236,218,18,0.076271186440678
133.03,2050,Single Family - Detached,965,943,22,0.0227979274611399
133.06,2012,Mobile Home,0,0,0,
133.06,2012,Multifamily,322,322,0,0
133.06,2012,Single Family - Detached,1041,989,52,0.0499519692603266
133.06,2020,Mobile Home,0,0,0,
133.06,2020,Multifamily,322,322,0,0
133.06,2020,Single Family - Detached,1041,984,57,0.0547550432276657
133.06,2025,Mobile Home,0,0,0,
133.06,2025,Multifamily,323,314,9,0.0278637770897833
133.06,2025,Single Family - Detached,1041,987,54,0.0518731988472622
133.06,2030,Mobile Home,0,0,0,
133.06,2030,Multifamily,323,313,10,0.0309597523219814
133.06,2030,Single Family - Detached,1041,987,54,0.0518731988472622
133.06,2035,Mobile Home,0,0,0,
133.06,2035,Multifamily,323,313,10,0.0309597523219814
133.06,2035,Single Family - Detached,1041,988,53,0.0509125840537944
133.06,2040,Mobile Home,0,0,0,
133.06,2040,Multifamily,323,311,12,0.0371517027863777
133.06,2040,Single Family - Detached,1041,984,57,0.0547550432276657
133.06,2045,Mobile Home,0,0,0,
133.06,2045,Multifamily,323,311,12,0.0371517027863777
133.06,2045,Single Family - Detached,1041,979,62,0.0595581171950048
133.06,2050,Mobile Home,0,0,0,
133.06,2050,Multifamily,323,311,12,0.0371517027863777
133.06,2050,Single Family - Detached,1041,977,64,0.0614793467819404
133.07,2012,Mobile Home,141,141,0,0
133.07,2012,Multifamily,77,76,1,0.012987012987013
133.07,2012,Single Family - Detached,804,805,-1,-0.00124378109452736
133.07,2020,Mobile Home,141,141,0,0
133.07,2020,Multifamily,77,76,1,0.012987012987013
133.07,2020,Single Family - Detached,804,800,4,0.00497512437810945
133.07,2025,Mobile Home,141,141,0,0
133.07,2025,Multifamily,79,73,6,0.0759493670886076
133.07,2025,Single Family - Detached,804,803,1,0.00124378109452736
133.07,2030,Mobile Home,141,140,1,0.00709219858156028
133.07,2030,Multifamily,79,73,6,0.0759493670886076
133.07,2030,Single Family - Detached,804,802,2,0.00248756218905473
133.07,2035,Mobile Home,141,140,1,0.00709219858156028
133.07,2035,Multifamily,79,74,5,0.0632911392405063
133.07,2035,Single Family - Detached,804,803,1,0.00124378109452736
133.07,2040,Mobile Home,141,140,1,0.00709219858156028
133.07,2040,Multifamily,79,72,7,0.0886075949367089
133.07,2040,Single Family - Detached,804,799,5,0.00621890547263682
133.07,2045,Mobile Home,141,139,2,0.0141843971631206
133.07,2045,Multifamily,79,72,7,0.0886075949367089
133.07,2045,Single Family - Detached,833,821,12,0.014405762304922
133.07,2050,Mobile Home,141,136,5,0.0354609929078014
133.07,2050,Multifamily,79,72,7,0.0886075949367089
133.07,2050,Single Family - Detached,834,822,12,0.0143884892086331
133.08,2012,Mobile Home,0,0,0,
133.08,2012,Multifamily,125,122,3,0.024
133.08,2012,Single Family - Detached,859,835,24,0.0279394644935972
133.08,2020,Mobile Home,0,0,0,
133.08,2020,Multifamily,125,119,6,0.048
133.08,2020,Single Family - Detached,859,833,26,0.030267753201397
133.08,2025,Mobile Home,0,0,0,
133.08,2025,Multifamily,130,123,7,0.0538461538461538
133.08,2025,Single Family - Detached,859,834,25,0.0291036088474971
133.08,2030,Mobile Home,0,0,0,
133.08,2030,Multifamily,131,125,6,0.0458015267175573
133.08,2030,Single Family - Detached,859,833,26,0.030267753201397
133.08,2035,Mobile Home,0,0,0,
133.08,2035,Multifamily,131,124,7,0.0534351145038168
133.08,2035,Single Family - Detached,859,833,26,0.030267753201397
133.08,2040,Mobile Home,0,0,0,
133.08,2040,Multifamily,224,211,13,0.0580357142857143
133.08,2040,Single Family - Detached,859,832,27,0.0314318975552969
133.08,2045,Mobile Home,0,0,0,
133.08,2045,Multifamily,224,210,14,0.0625
133.08,2045,Single Family - Detached,864,836,28,0.0324074074074074
133.08,2050,Mobile Home,0,0,0,
133.08,2050,Multifamily,224,210,14,0.0625
133.08,2050,Single Family - Detached,865,836,29,0.0335260115606936
133.09,2012,Mobile Home,0,0,0,
133.09,2012,Multifamily,152,152,0,0
133.09,2012,Single Family - Detached,1815,1785,30,0.0165289256198347
133.09,2020,Mobile Home,0,0,0,
133.09,2020,Multifamily,152,152,0,0
133.09,2020,Single Family - Detached,1815,1784,31,0.0170798898071625
133.09,2025,Mobile Home,0,0,0,
133.09,2025,Multifamily,152,150,2,0.0131578947368421
133.09,2025,Single Family - Detached,1815,1785,30,0.0165289256198347
133.09,2030,Mobile Home,0,0,0,
133.09,2030,Multifamily,152,150,2,0.0131578947368421
133.09,2030,Single Family - Detached,1816,1785,31,0.0170704845814978
133.09,2035,Mobile Home,0,0,0,
133.09,2035,Multifamily,152,150,2,0.0131578947368421
133.09,2035,Single Family - Detached,1816,1786,30,0.0165198237885463
133.09,2040,Mobile Home,0,0,0,
133.09,2040,Multifamily,152,150,2,0.0131578947368421
133.09,2040,Single Family - Detached,1816,1785,31,0.0170704845814978
133.09,2045,Mobile Home,0,0,0,
133.09,2045,Multifamily,152,150,2,0.0131578947368421
133.09,2045,Single Family - Detached,1836,1805,31,0.0168845315904139
133.09,2050,Mobile Home,0,0,0,
133.09,2050,Multifamily,152,150,2,0.0131578947368421
133.09,2050,Single Family - Detached,1836,1805,31,0.0168845315904139
133.10,2012,Mobile Home,0,0,0,
133.10,2012,Multifamily,3633,3508,125,0.0344068263143408
133.10,2012,Single Family - Detached,5025,4961,64,0.0127363184079602
133.10,2020,Mobile Home,0,0,0,
133.10,2020,Multifamily,3633,3497,136,0.0374346270300028
133.10,2020,Single Family - Detached,5025,4947,78,0.0155223880597015
133.10,2025,Mobile Home,0,0,0,
133.10,2025,Multifamily,3634,3563,71,0.019537699504678
133.10,2025,Single Family - Detached,5025,4961,64,0.0127363184079602
133.10,2030,Mobile Home,0,0,0,
133.10,2030,Multifamily,3634,3563,71,0.019537699504678
133.10,2030,Single Family - Detached,5025,4961,64,0.0127363184079602
133.10,2035,Mobile Home,0,0,0,
133.10,2035,Multifamily,3634,3564,70,0.019262520638415
133.10,2035,Single Family - Detached,5025,4961,64,0.0127363184079602
133.10,2040,Mobile Home,0,0,0,
133.10,2040,Multifamily,3806,3713,93,0.0244351024697846
133.10,2040,Single Family - Detached,5025,4952,73,0.0145273631840796
133.10,2045,Mobile Home,0,0,0,
133.10,2045,Multifamily,3806,3684,122,0.0320546505517604
133.10,2045,Single Family - Detached,5025,4941,84,0.0167164179104478
133.10,2050,Mobile Home,0,0,0,
133.10,2050,Multifamily,3806,3677,129,0.033893851812927
133.10,2050,Single Family - Detached,5025,4941,84,0.0167164179104478
133.11,2012,Mobile Home,0,0,0,
133.11,2012,Multifamily,430,408,22,0.0511627906976744
133.11,2012,Single Family - Detached,2548,2466,82,0.032182103610675
133.11,2020,Mobile Home,0,0,0,
133.11,2020,Multifamily,460,452,8,0.0173913043478261
133.11,2020,Single Family - Detached,2650,2567,83,0.0313207547169811
133.11,2025,Mobile Home,0,0,0,
133.11,2025,Multifamily,460,456,4,0.00869565217391304
133.11,2025,Single Family - Detached,2650,2573,77,0.0290566037735849
133.11,2030,Mobile Home,0,0,0,
133.11,2030,Multifamily,460,456,4,0.00869565217391304
133.11,2030,Single Family - Detached,2650,2571,79,0.029811320754717
133.11,2035,Mobile Home,0,0,0,
133.11,2035,Multifamily,460,459,1,0.00217391304347826
133.11,2035,Single Family - Detached,2650,2577,73,0.0275471698113208
133.11,2040,Mobile Home,0,0,0,
133.11,2040,Multifamily,460,453,7,0.0152173913043478
133.11,2040,Single Family - Detached,2650,2568,82,0.0309433962264151
133.11,2045,Mobile Home,0,0,0,
133.11,2045,Multifamily,460,447,13,0.0282608695652174
133.11,2045,Single Family - Detached,2650,2563,87,0.0328301886792453
133.11,2050,Mobile Home,0,0,0,
133.11,2050,Multifamily,460,446,14,0.0304347826086957
133.11,2050,Single Family - Detached,2650,2562,88,0.0332075471698113
133.12,2012,Mobile Home,0,0,0,
133.12,2012,Multifamily,152,148,4,0.0263157894736842
133.12,2012,Single Family - Detached,662,662,0,0
133.12,2020,Mobile Home,0,0,0,
133.12,2020,Multifamily,152,148,4,0.0263157894736842
133.12,2020,Single Family - Detached,662,662,0,0
133.12,2025,Mobile Home,0,0,0,
133.12,2025,Multifamily,152,146,6,0.0394736842105263
133.12,2025,Single Family - Detached,662,662,0,0
133.12,2030,Mobile Home,0,0,0,
133.12,2030,Multifamily,152,146,6,0.0394736842105263
133.12,2030,Single Family - Detached,662,662,0,0
133.12,2035,Mobile Home,0,0,0,
133.12,2035,Multifamily,152,146,6,0.0394736842105263
133.12,2035,Single Family - Detached,662,662,0,0
133.12,2040,Mobile Home,0,0,0,
133.12,2040,Multifamily,156,154,2,0.0128205128205128
133.12,2040,Single Family - Detached,662,662,0,0
133.12,2045,Mobile Home,0,0,0,
133.12,2045,Multifamily,156,154,2,0.0128205128205128
133.12,2045,Single Family - Detached,662,662,0,0
133.12,2050,Mobile Home,0,0,0,
133.12,2050,Multifamily,156,154,2,0.0128205128205128
133.12,2050,Single Family - Detached,662,662,0,0
133.13,2012,Mobile Home,0,0,0,
133.13,2012,Multifamily,1257,1177,80,0.0636435958631663
133.13,2012,Single Family - Detached,1937,1908,29,0.0149716055756324
133.13,2020,Mobile Home,0,0,0,
133.13,2020,Multifamily,5182,4945,237,0.0457352373600926
133.13,2020,Single Family - Detached,3330,3255,75,0.0225225225225225
133.13,2025,Mobile Home,0,0,0,
133.13,2025,Multifamily,7646,7357,289,0.037797541198012
133.13,2025,Single Family - Detached,5740,5641,99,0.0172473867595819
133.13,2030,Mobile Home,0,0,0,
133.13,2030,Multifamily,7646,7357,289,0.037797541198012
133.13,2030,Single Family - Detached,5740,5641,99,0.0172473867595819
133.13,2035,Mobile Home,0,0,0,
133.13,2035,Multifamily,7646,7368,278,0.0363588804603714
133.13,2035,Single Family - Detached,5740,5647,93,0.0162020905923345
133.13,2040,Mobile Home,0,0,0,
133.13,2040,Multifamily,9052,8725,327,0.0361246133451171
133.13,2040,Single Family - Detached,5691,5586,105,0.018450184501845
133.13,2045,Mobile Home,0,0,0,
133.13,2045,Multifamily,9774,9455,319,0.0326376099856763
133.13,2045,Single Family - Detached,5704,5586,118,0.020687237026648
133.13,2050,Mobile Home,0,0,0,
133.13,2050,Multifamily,9795,9465,330,0.0336906584992343
133.13,2050,Single Family - Detached,5706,5583,123,0.0215562565720294
133.14,2012,Mobile Home,0,0,0,
133.14,2012,Multifamily,1036,1036,0,0
133.14,2012,Single Family - Detached,3327,3261,66,0.0198376916140667
133.14,2020,Mobile Home,0,0,0,
133.14,2020,Multifamily,5484,5327,157,0.0286287381473377
133.14,2020,Single Family - Detached,3356,3271,85,0.0253277711561383
133.14,2025,Mobile Home,0,0,0,
133.14,2025,Multifamily,8054,7832,222,0.0275639433821704
133.14,2025,Single Family - Detached,4084,3997,87,0.0213026444662096
133.14,2030,Mobile Home,0,0,0,
133.14,2030,Multifamily,8054,7831,223,0.0276881052892972
133.14,2030,Single Family - Detached,4084,3997,87,0.0213026444662096
133.14,2035,Mobile Home,0,0,0,
133.14,2035,Multifamily,8054,7834,220,0.0273156195679166
133.14,2035,Single Family - Detached,4084,4001,83,0.0203232125367287
133.14,2040,Mobile Home,0,0,0,
133.14,2040,Multifamily,8054,7800,254,0.0315371244102309
133.14,2040,Single Family - Detached,4084,3991,93,0.022771792360431
133.14,2045,Mobile Home,0,0,0,
133.14,2045,Multifamily,8109,7811,298,0.0367492909113331
133.14,2045,Single Family - Detached,4084,3983,101,0.0247306562193928
133.14,2050,Mobile Home,0,0,0,
133.14,2050,Multifamily,8135,7829,306,0.0376152427781192
133.14,2050,Single Family - Detached,4084,3980,104,0.0254652301665034
134.01,2012,Mobile Home,0,0,0,
134.01,2012,Multifamily,90,78,12,0.133333333333333
134.01,2012,Single Family - Detached,1345,1330,15,0.0111524163568773
134.01,2020,Mobile Home,0,0,0,
134.01,2020,Multifamily,90,83,7,0.0777777777777778
134.01,2020,Single Family - Detached,1346,1325,21,0.0156017830609212
134.01,2025,Mobile Home,0,0,0,
134.01,2025,Multifamily,90,84,6,0.0666666666666667
134.01,2025,Single Family - Detached,1346,1330,16,0.011887072808321
134.01,2030,Mobile Home,0,0,0,
134.01,2030,Multifamily,90,84,6,0.0666666666666667
134.01,2030,Single Family - Detached,1348,1332,16,0.0118694362017804
134.01,2035,Mobile Home,0,0,0,
134.01,2035,Multifamily,90,85,5,0.0555555555555556
134.01,2035,Single Family - Detached,1348,1333,15,0.0111275964391691
134.01,2040,Mobile Home,0,0,0,
134.01,2040,Multifamily,90,85,5,0.0555555555555556
134.01,2040,Single Family - Detached,1356,1330,26,0.0191740412979351
134.01,2045,Mobile Home,0,0,0,
134.01,2045,Multifamily,90,85,5,0.0555555555555556
134.01,2045,Single Family - Detached,1356,1325,31,0.0228613569321534
134.01,2050,Mobile Home,0,0,0,
134.01,2050,Multifamily,90,85,5,0.0555555555555556
134.01,2050,Single Family - Detached,1356,1325,31,0.0228613569321534
134.09,2012,Mobile Home,0,0,0,
134.09,2012,Multifamily,593,572,21,0.0354131534569983
134.09,2012,Single Family - Detached,1294,1271,23,0.017774343122102
134.09,2020,Mobile Home,0,0,0,
134.09,2020,Multifamily,593,573,20,0.0337268128161889
134.09,2020,Single Family - Detached,1295,1273,22,0.016988416988417
134.09,2025,Mobile Home,0,0,0,
134.09,2025,Multifamily,593,574,19,0.0320404721753794
134.09,2025,Single Family - Detached,1295,1275,20,0.0154440154440154
134.09,2030,Mobile Home,0,0,0,
134.09,2030,Multifamily,593,574,19,0.0320404721753794
134.09,2030,Single Family - Detached,1295,1269,26,0.0200772200772201
134.09,2035,Mobile Home,0,0,0,
134.09,2035,Multifamily,593,575,18,0.03035413153457
134.09,2035,Single Family - Detached,1295,1270,25,0.0193050193050193
134.09,2040,Mobile Home,0,0,0,
134.09,2040,Multifamily,593,575,18,0.03035413153457
134.09,2040,Single Family - Detached,1295,1268,27,0.0208494208494209
134.09,2045,Mobile Home,0,0,0,
134.09,2045,Multifamily,593,575,18,0.03035413153457
134.09,2045,Single Family - Detached,1295,1262,33,0.0254826254826255
134.09,2050,Mobile Home,0,0,0,
134.09,2050,Multifamily,593,575,18,0.03035413153457
134.09,2050,Single Family - Detached,1295,1260,35,0.027027027027027
134.10,2012,Mobile Home,0,0,0,
134.10,2012,Multifamily,327,310,17,0.0519877675840979
134.10,2012,Single Family - Detached,1996,1966,30,0.0150300601202405
134.10,2020,Mobile Home,0,0,0,
134.10,2020,Multifamily,327,316,11,0.0336391437308868
134.10,2020,Single Family - Detached,2128,2076,52,0.0244360902255639
134.10,2025,Mobile Home,0,0,0,
134.10,2025,Multifamily,327,317,10,0.0305810397553517
134.10,2025,Single Family - Detached,2148,2104,44,0.0204841713221601
134.10,2030,Mobile Home,0,0,0,
134.10,2030,Multifamily,327,317,10,0.0305810397553517
134.10,2030,Single Family - Detached,2184,2142,42,0.0192307692307692
134.10,2035,Mobile Home,0,0,0,
134.10,2035,Multifamily,327,318,9,0.0275229357798165
134.10,2035,Single Family - Detached,2184,2144,40,0.0183150183150183
134.10,2040,Mobile Home,0,0,0,
134.10,2040,Multifamily,327,316,11,0.0336391437308868
134.10,2040,Single Family - Detached,2226,2177,49,0.0220125786163522
134.10,2045,Mobile Home,0,0,0,
134.10,2045,Multifamily,327,315,12,0.036697247706422
134.10,2045,Single Family - Detached,2246,2191,55,0.0244879786286732
134.10,2050,Mobile Home,0,0,0,
134.10,2050,Multifamily,327,314,13,0.0397553516819572
134.10,2050,Single Family - Detached,2275,2218,57,0.0250549450549451
134.11,2012,Mobile Home,0,0,0,
134.11,2012,Multifamily,1,0,1,1
134.11,2012,Single Family - Detached,1738,1669,69,0.0397008055235903
134.11,2020,Mobile Home,0,0,0,
134.11,2020,Multifamily,1,1,0,0
134.11,2020,Single Family - Detached,1853,1778,75,0.0404749055585537
134.11,2025,Mobile Home,0,0,0,
134.11,2025,Multifamily,1,1,0,0
134.11,2025,Single Family - Detached,1883,1815,68,0.0361125862984599
134.11,2030,Mobile Home,0,0,0,
134.11,2030,Multifamily,1,1,0,0
134.11,2030,Single Family - Detached,1905,1826,79,0.0414698162729659
134.11,2035,Mobile Home,0,0,0,
134.11,2035,Multifamily,1,1,0,0
134.11,2035,Single Family - Detached,1905,1827,78,0.0409448818897638
134.11,2040,Mobile Home,0,0,0,
134.11,2040,Multifamily,1,0,1,1
134.11,2040,Single Family - Detached,1905,1823,82,0.0430446194225722
134.11,2045,Mobile Home,0,0,0,
134.11,2045,Multifamily,1,0,1,1
134.11,2045,Single Family - Detached,1905,1812,93,0.0488188976377953
134.11,2050,Mobile Home,0,0,0,
134.11,2050,Multifamily,1,0,1,1
134.11,2050,Single Family - Detached,1905,1808,97,0.0509186351706037
134.12,2012,Mobile Home,0,0,0,
134.12,2012,Multifamily,593,563,30,0.0505902192242833
134.12,2012,Single Family - Detached,1341,1204,137,0.102162565249814
134.12,2020,Mobile Home,0,0,0,
134.12,2020,Multifamily,550,529,21,0.0381818181818182
134.12,2020,Single Family - Detached,1343,1200,143,0.106478034251675
134.12,2025,Mobile Home,0,0,0,
134.12,2025,Multifamily,535,518,17,0.0317757009345794
134.12,2025,Single Family - Detached,1344,1206,138,0.102678571428571
134.12,2030,Mobile Home,0,0,0,
134.12,2030,Multifamily,520,504,16,0.0307692307692308
134.12,2030,Single Family - Detached,1375,1257,118,0.0858181818181818
134.12,2035,Mobile Home,0,0,0,
134.12,2035,Multifamily,502,488,14,0.0278884462151394
134.12,2035,Single Family - Detached,1375,1260,115,0.0836363636363636
134.12,2040,Mobile Home,0,0,0,
134.12,2040,Multifamily,485,470,15,0.0309278350515464
134.12,2040,Single Family - Detached,1411,1317,94,0.0666194188518781
134.12,2045,Mobile Home,0,0,0,
134.12,2045,Multifamily,477,462,15,0.0314465408805031
134.12,2045,Single Family - Detached,1413,1314,99,0.0700636942675159
134.12,2050,Mobile Home,0,0,0,
134.12,2050,Multifamily,458,444,14,0.0305676855895196
134.12,2050,Single Family - Detached,1414,1312,102,0.0721357850070721
134.14,2012,Mobile Home,0,0,0,
134.14,2012,Multifamily,280,280,0,0
134.14,2012,Single Family - Detached,1943,1919,24,0.0123520329387545
134.14,2020,Mobile Home,0,0,0,
134.14,2020,Multifamily,280,280,0,0
134.14,2020,Single Family - Detached,1945,1914,31,0.0159383033419023
134.14,2025,Mobile Home,0,0,0,
134.14,2025,Multifamily,280,280,0,0
134.14,2025,Single Family - Detached,1945,1915,30,0.0154241645244216
134.14,2030,Mobile Home,0,0,0,
134.14,2030,Multifamily,280,280,0,0
134.14,2030,Single Family - Detached,1945,1908,37,0.0190231362467866
134.14,2035,Mobile Home,0,0,0,
134.14,2035,Multifamily,280,280,0,0
134.14,2035,Single Family - Detached,1945,1909,36,0.0185089974293059
134.14,2040,Mobile Home,0,0,0,
134.14,2040,Multifamily,280,279,1,0.00357142857142857
134.14,2040,Single Family - Detached,1945,1907,38,0.0195372750642674
134.14,2045,Mobile Home,0,0,0,
134.14,2045,Multifamily,280,278,2,0.00714285714285714
134.14,2045,Single Family - Detached,1945,1900,45,0.0231362467866324
134.14,2050,Mobile Home,0,0,0,
134.14,2050,Multifamily,280,277,3,0.0107142857142857
134.14,2050,Single Family - Detached,1945,1898,47,0.0241645244215938
134.15,2012,Mobile Home,0,0,0,
134.15,2012,Multifamily,0,0,0,
134.15,2012,Single Family - Detached,545,533,12,0.0220183486238532
134.15,2020,Mobile Home,0,0,0,
134.15,2020,Multifamily,0,0,0,
134.15,2020,Single Family - Detached,545,532,13,0.0238532110091743
134.15,2025,Mobile Home,0,0,0,
134.15,2025,Multifamily,0,0,0,
134.15,2025,Single Family - Detached,545,532,13,0.0238532110091743
134.15,2030,Mobile Home,0,0,0,
134.15,2030,Multifamily,0,0,0,
134.15,2030,Single Family - Detached,545,530,15,0.0275229357798165
134.15,2035,Mobile Home,0,0,0,
134.15,2035,Multifamily,0,0,0,
134.15,2035,Single Family - Detached,545,530,15,0.0275229357798165
134.15,2040,Mobile Home,0,0,0,
134.15,2040,Multifamily,0,0,0,
134.15,2040,Single Family - Detached,545,530,15,0.0275229357798165
134.15,2045,Mobile Home,0,0,0,
134.15,2045,Multifamily,0,0,0,
134.15,2045,Single Family - Detached,545,529,16,0.0293577981651376
134.15,2050,Mobile Home,0,0,0,
134.15,2050,Multifamily,0,0,0,
134.15,2050,Single Family - Detached,545,529,16,0.0293577981651376
134.16,2012,Mobile Home,0,0,0,
134.16,2012,Multifamily,0,0,0,
134.16,2012,Single Family - Detached,1257,1233,24,0.0190930787589499
134.16,2020,Mobile Home,0,0,0,
134.16,2020,Multifamily,0,0,0,
134.16,2020,Single Family - Detached,1258,1236,22,0.0174880763116057
134.16,2025,Mobile Home,0,0,0,
134.16,2025,Multifamily,0,0,0,
134.16,2025,Single Family - Detached,1258,1238,20,0.0158982511923688
134.16,2030,Mobile Home,0,0,0,
134.16,2030,Multifamily,0,0,0,
134.16,2030,Single Family - Detached,1258,1238,20,0.0158982511923688
134.16,2035,Mobile Home,0,0,0,
134.16,2035,Multifamily,0,0,0,
134.16,2035,Single Family - Detached,1258,1238,20,0.0158982511923688
134.16,2040,Mobile Home,0,0,0,
134.16,2040,Multifamily,0,0,0,
134.16,2040,Single Family - Detached,1258,1236,22,0.0174880763116057
134.16,2045,Mobile Home,0,0,0,
134.16,2045,Multifamily,0,0,0,
134.16,2045,Single Family - Detached,1258,1235,23,0.0182829888712242
134.16,2050,Mobile Home,0,0,0,
134.16,2050,Multifamily,0,0,0,
134.16,2050,Single Family - Detached,1258,1235,23,0.0182829888712242
134.17,2012,Mobile Home,0,0,0,
134.17,2012,Multifamily,0,0,0,
134.17,2012,Single Family - Detached,623,621,2,0.00321027287319422
134.17,2020,Mobile Home,0,0,0,
134.17,2020,Multifamily,0,0,0,
134.17,2020,Single Family - Detached,623,619,4,0.00642054574638844
134.17,2025,Mobile Home,0,0,0,
134.17,2025,Multifamily,0,0,0,
134.17,2025,Single Family - Detached,623,619,4,0.00642054574638844
134.17,2030,Mobile Home,0,0,0,
134.17,2030,Multifamily,0,0,0,
134.17,2030,Single Family - Detached,623,619,4,0.00642054574638844
134.17,2035,Mobile Home,0,0,0,
134.17,2035,Multifamily,0,0,0,
134.17,2035,Single Family - Detached,623,621,2,0.00321027287319422
134.17,2040,Mobile Home,0,0,0,
134.17,2040,Multifamily,0,0,0,
134.17,2040,Single Family - Detached,623,620,3,0.00481540930979133
134.17,2045,Mobile Home,0,0,0,
134.17,2045,Multifamily,0,0,0,
134.17,2045,Single Family - Detached,623,620,3,0.00481540930979133
134.17,2050,Mobile Home,0,0,0,
134.17,2050,Multifamily,0,0,0,
134.17,2050,Single Family - Detached,623,620,3,0.00481540930979133
134.18,2012,Mobile Home,197,197,0,0
134.18,2012,Multifamily,654,620,34,0.0519877675840979
134.18,2012,Single Family - Detached,1282,1231,51,0.0397815912636505
134.18,2020,Mobile Home,197,197,0,0
134.18,2020,Multifamily,654,619,35,0.0535168195718654
134.18,2020,Single Family - Detached,1283,1229,54,0.0420888542478566
134.18,2025,Mobile Home,197,197,0,0
134.18,2025,Multifamily,654,619,35,0.0535168195718654
134.18,2025,Single Family - Detached,1283,1231,52,0.0405300077942323
134.18,2030,Mobile Home,197,196,1,0.0050761421319797
134.18,2030,Multifamily,654,619,35,0.0535168195718654
134.18,2030,Single Family - Detached,1283,1230,53,0.0413094310210444
134.18,2035,Mobile Home,197,196,1,0.0050761421319797
134.18,2035,Multifamily,654,620,34,0.0519877675840979
134.18,2035,Single Family - Detached,1283,1232,51,0.0397505845674201
134.18,2040,Mobile Home,197,196,1,0.0050761421319797
134.18,2040,Multifamily,654,619,35,0.0535168195718654
134.18,2040,Single Family - Detached,1283,1229,54,0.0420888542478566
134.18,2045,Mobile Home,197,195,2,0.0101522842639594
134.18,2045,Multifamily,654,619,35,0.0535168195718654
134.18,2045,Single Family - Detached,1283,1227,56,0.0436477007014809
134.18,2050,Mobile Home,197,191,6,0.0304568527918782
134.18,2050,Multifamily,654,619,35,0.0535168195718654
134.18,2050,Single Family - Detached,1283,1225,58,0.0452065471551052
134.19,2012,Mobile Home,0,0,0,
134.19,2012,Multifamily,760,719,41,0.0539473684210526
134.19,2012,Single Family - Detached,1607,1596,11,0.00684505289359054
134.19,2020,Mobile Home,0,0,0,
134.19,2020,Multifamily,760,718,42,0.0552631578947368
134.19,2020,Single Family - Detached,1640,1632,8,0.0048780487804878
134.19,2025,Mobile Home,0,0,0,
134.19,2025,Multifamily,760,718,42,0.0552631578947368
134.19,2025,Single Family - Detached,1640,1633,7,0.00426829268292683
134.19,2030,Mobile Home,0,0,0,
134.19,2030,Multifamily,760,718,42,0.0552631578947368
134.19,2030,Single Family - Detached,1701,1692,9,0.00529100529100529
134.19,2035,Mobile Home,0,0,0,
134.19,2035,Multifamily,760,718,42,0.0552631578947368
134.19,2035,Single Family - Detached,1742,1738,4,0.00229621125143513
134.19,2040,Mobile Home,0,0,0,
134.19,2040,Multifamily,760,717,43,0.0565789473684211
134.19,2040,Single Family - Detached,1760,1751,9,0.00511363636363636
134.19,2045,Mobile Home,0,0,0,
134.19,2045,Multifamily,760,717,43,0.0565789473684211
134.19,2045,Single Family - Detached,1760,1750,10,0.00568181818181818
134.19,2050,Mobile Home,0,0,0,
134.19,2050,Multifamily,760,717,43,0.0565789473684211
134.19,2050,Single Family - Detached,1762,1751,11,0.00624290578887628
134.20,2012,Mobile Home,0,0,0,
134.20,2012,Multifamily,502,477,25,0.049800796812749
134.20,2012,Single Family - Detached,638,614,24,0.0376175548589342
134.20,2020,Mobile Home,0,0,0,
134.20,2020,Multifamily,502,479,23,0.0458167330677291
134.20,2020,Single Family - Detached,638,612,26,0.0407523510971787
134.20,2025,Mobile Home,0,0,0,
134.20,2025,Multifamily,502,479,23,0.0458167330677291
134.20,2025,Single Family - Detached,638,612,26,0.0407523510971787
134.20,2030,Mobile Home,0,0,0,
134.20,2030,Multifamily,502,479,23,0.0458167330677291
134.20,2030,Single Family - Detached,638,612,26,0.0407523510971787
134.20,2035,Mobile Home,0,0,0,
134.20,2035,Multifamily,502,479,23,0.0458167330677291
134.20,2035,Single Family - Detached,638,612,26,0.0407523510971787
134.20,2040,Mobile Home,0,0,0,
134.20,2040,Multifamily,502,477,25,0.049800796812749
134.20,2040,Single Family - Detached,638,612,26,0.0407523510971787
134.20,2045,Mobile Home,0,0,0,
134.20,2045,Multifamily,502,477,25,0.049800796812749
134.20,2045,Single Family - Detached,638,612,26,0.0407523510971787
134.20,2050,Mobile Home,0,0,0,
134.20,2050,Multifamily,502,477,25,0.049800796812749
134.20,2050,Single Family - Detached,638,612,26,0.0407523510971787
134.21,2012,Mobile Home,0,0,0,
134.21,2012,Multifamily,439,431,8,0.0182232346241458
134.21,2012,Single Family - Detached,1028,976,52,0.0505836575875486
134.21,2020,Mobile Home,0,0,0,
134.21,2020,Multifamily,439,432,7,0.0159453302961276
134.21,2020,Single Family - Detached,1028,973,55,0.0535019455252918
134.21,2025,Mobile Home,0,0,0,
134.21,2025,Multifamily,439,433,6,0.0136674259681093
134.21,2025,Single Family - Detached,1028,973,55,0.0535019455252918
134.21,2030,Mobile Home,0,0,0,
134.21,2030,Multifamily,439,433,6,0.0136674259681093
134.21,2030,Single Family - Detached,1028,970,58,0.056420233463035
134.21,2035,Mobile Home,0,0,0,
134.21,2035,Multifamily,439,434,5,0.0113895216400911
134.21,2035,Single Family - Detached,1028,970,58,0.056420233463035
134.21,2040,Mobile Home,0,0,0,
134.21,2040,Multifamily,439,433,6,0.0136674259681093
134.21,2040,Single Family - Detached,1028,970,58,0.056420233463035
134.21,2045,Mobile Home,0,0,0,
134.21,2045,Multifamily,439,433,6,0.0136674259681093
134.21,2045,Single Family - Detached,1028,967,61,0.0593385214007782
134.21,2050,Mobile Home,0,0,0,
134.21,2050,Multifamily,439,433,6,0.0136674259681093
134.21,2050,Single Family - Detached,1028,967,61,0.0593385214007782
135.03,2012,Mobile Home,0,0,0,
135.03,2012,Multifamily,804,794,10,0.0124378109452736
135.03,2012,Single Family - Detached,1288,1244,44,0.0341614906832298
135.03,2020,Mobile Home,0,0,0,
135.03,2020,Multifamily,804,693,111,0.138059701492537
135.03,2020,Single Family - Detached,1516,1426,90,0.0593667546174142
135.03,2025,Mobile Home,0,0,0,
135.03,2025,Multifamily,811,719,92,0.1134401972873
135.03,2025,Single Family - Detached,1705,1650,55,0.032258064516129
135.03,2030,Mobile Home,0,0,0,
135.03,2030,Multifamily,820,730,90,0.109756097560976
135.03,2030,Single Family - Detached,1701,1636,65,0.0382128159905938
135.03,2035,Mobile Home,0,0,0,
135.03,2035,Multifamily,820,730,90,0.109756097560976
135.03,2035,Single Family - Detached,1696,1635,61,0.0359669811320755
135.03,2040,Mobile Home,0,0,0,
135.03,2040,Multifamily,829,710,119,0.143546441495778
135.03,2040,Single Family - Detached,1696,1444,252,0.148584905660377
135.03,2045,Mobile Home,0,0,0,
135.03,2045,Multifamily,829,708,121,0.145958986731001
135.03,2045,Single Family - Detached,1697,1410,287,0.169121979964643
135.03,2050,Mobile Home,0,0,0,
135.03,2050,Multifamily,829,706,123,0.148371531966224
135.03,2050,Single Family - Detached,1697,1391,306,0.180318208603418
135.04,2012,Mobile Home,0,0,0,
135.04,2012,Multifamily,200,200,0,0
135.04,2012,Single Family - Detached,1022,968,54,0.0528375733855186
135.04,2020,Mobile Home,0,0,0,
135.04,2020,Multifamily,200,140,60,0.3
135.04,2020,Single Family - Detached,1072,1029,43,0.0401119402985075
135.04,2025,Mobile Home,0,0,0,
135.04,2025,Multifamily,200,132,68,0.34
135.04,2025,Single Family - Detached,1193,1168,25,0.0209555741827326
135.04,2030,Mobile Home,0,0,0,
135.04,2030,Multifamily,200,131,69,0.345
135.04,2030,Single Family - Detached,1220,1191,29,0.0237704918032787
135.04,2035,Mobile Home,0,0,0,
135.04,2035,Multifamily,200,131,69,0.345
135.04,2035,Single Family - Detached,1220,1191,29,0.0237704918032787
135.04,2040,Mobile Home,0,0,0,
135.04,2040,Multifamily,202,125,77,0.381188118811881
135.04,2040,Single Family - Detached,1288,1157,131,0.101708074534161
135.04,2045,Mobile Home,0,0,0,
135.04,2045,Multifamily,202,125,77,0.381188118811881
135.04,2045,Single Family - Detached,1288,1135,153,0.118788819875776
135.04,2050,Mobile Home,0,0,0,
135.04,2050,Multifamily,202,125,77,0.381188118811881
135.04,2050,Single Family - Detached,1288,1126,162,0.125776397515528
135.05,2012,Mobile Home,130,122,8,0.0615384615384615
135.05,2012,Multifamily,552,792,-240,-0.434782608695652
135.05,2012,Single Family - Detached,1238,923,315,0.254442649434572
135.05,2020,Mobile Home,130,123,7,0.0538461538461538
135.05,2020,Multifamily,552,703,-151,-0.273550724637681
135.05,2020,Single Family - Detached,1495,1125,370,0.247491638795987
135.05,2025,Mobile Home,130,122,8,0.0615384615384615
135.05,2025,Multifamily,552,693,-141,-0.255434782608696
135.05,2025,Single Family - Detached,1502,1142,360,0.239680426098535
135.05,2030,Mobile Home,130,121,9,0.0692307692307692
135.05,2030,Multifamily,552,692,-140,-0.253623188405797
135.05,2030,Single Family - Detached,1502,1139,363,0.24167776298269
135.05,2035,Mobile Home,130,122,8,0.0615384615384615
135.05,2035,Multifamily,552,692,-140,-0.253623188405797
135.05,2035,Single Family - Detached,1502,1139,363,0.24167776298269
135.05,2040,Mobile Home,130,123,7,0.0538461538461538
135.05,2040,Multifamily,582,755,-173,-0.297250859106529
135.05,2040,Single Family - Detached,1600,1497,103,0.064375
135.05,2045,Mobile Home,130,122,8,0.0615384615384615
135.05,2045,Multifamily,582,755,-173,-0.297250859106529
135.05,2045,Single Family - Detached,1600,1484,116,0.0725
135.05,2050,Mobile Home,130,118,12,0.0923076923076923
135.05,2050,Multifamily,582,755,-173,-0.297250859106529
135.05,2050,Single Family - Detached,1600,1481,119,0.074375
135.06,2012,Mobile Home,471,444,27,0.0573248407643312
135.06,2012,Multifamily,0,0,0,
135.06,2012,Single Family - Detached,602,575,27,0.0448504983388704
135.06,2020,Mobile Home,471,445,26,0.0552016985138004
135.06,2020,Multifamily,0,0,0,
135.06,2020,Single Family - Detached,608,573,35,0.0575657894736842
135.06,2025,Mobile Home,471,445,26,0.0552016985138004
135.06,2025,Multifamily,0,0,0,
135.06,2025,Single Family - Detached,989,924,65,0.0657229524772497
135.06,2030,Mobile Home,471,443,28,0.059447983014862
135.06,2030,Multifamily,0,0,0,
135.06,2030,Single Family - Detached,1022,957,65,0.063600782778865
135.06,2035,Mobile Home,471,443,28,0.059447983014862
135.06,2035,Multifamily,0,0,0,
135.06,2035,Single Family - Detached,1022,957,65,0.063600782778865
135.06,2040,Mobile Home,471,443,28,0.059447983014862
135.06,2040,Multifamily,0,0,0,
135.06,2040,Single Family - Detached,1221,1124,97,0.0794430794430794
135.06,2045,Mobile Home,471,441,30,0.0636942675159236
135.06,2045,Multifamily,0,0,0,
135.06,2045,Single Family - Detached,1496,1386,110,0.0735294117647059
135.06,2050,Mobile Home,471,434,37,0.0785562632696391
135.06,2050,Multifamily,0,0,0,
135.06,2050,Single Family - Detached,1498,1398,100,0.0667556742323097
136.01,2012,Mobile Home,0,0,0,
136.01,2012,Multifamily,503,452,51,0.101391650099404
136.01,2012,Single Family - Detached,1478,1435,43,0.0290933694181326
136.01,2020,Mobile Home,0,0,0,
136.01,2020,Multifamily,511,477,34,0.0665362035225049
136.01,2020,Single Family - Detached,1462,1417,45,0.0307797537619699
136.01,2025,Mobile Home,0,0,0,
136.01,2025,Multifamily,512,483,29,0.056640625
136.01,2025,Single Family - Detached,1462,1418,44,0.0300957592339261
136.01,2030,Mobile Home,0,0,0,
136.01,2030,Multifamily,520,490,30,0.0576923076923077
136.01,2030,Single Family - Detached,1458,1414,44,0.0301783264746228
136.01,2035,Mobile Home,0,0,0,
136.01,2035,Multifamily,520,491,29,0.0557692307692308
136.01,2035,Single Family - Detached,1458,1414,44,0.0301783264746228
136.01,2040,Mobile Home,0,0,0,
136.01,2040,Multifamily,551,519,32,0.058076225045372
136.01,2040,Single Family - Detached,1448,1401,47,0.0324585635359116
136.01,2045,Mobile Home,0,0,0,
136.01,2045,Multifamily,560,525,35,0.0625
136.01,2045,Single Family - Detached,1445,1396,49,0.0339100346020761
136.01,2050,Mobile Home,0,0,0,
136.01,2050,Multifamily,564,528,36,0.0638297872340425
136.01,2050,Single Family - Detached,1445,1395,50,0.0346020761245675
136.04,2012,Mobile Home,0,0,0,
136.04,2012,Multifamily,678,640,38,0.056047197640118
136.04,2012,Single Family - Detached,1516,1503,13,0.00857519788918206
136.04,2020,Mobile Home,0,0,0,
136.04,2020,Multifamily,678,642,36,0.0530973451327434
136.04,2020,Single Family - Detached,1516,1502,14,0.00923482849604222
136.04,2025,Mobile Home,0,0,0,
136.04,2025,Multifamily,678,645,33,0.0486725663716814
136.04,2025,Single Family - Detached,1532,1516,16,0.010443864229765
136.04,2030,Mobile Home,0,0,0,
136.04,2030,Multifamily,678,645,33,0.0486725663716814
136.04,2030,Single Family - Detached,1533,1516,17,0.0110893672537508
136.04,2035,Mobile Home,0,0,0,
136.04,2035,Multifamily,678,647,31,0.0457227138643068
136.04,2035,Single Family - Detached,1533,1517,16,0.0104370515329419
136.04,2040,Mobile Home,0,0,0,
136.04,2040,Multifamily,678,645,33,0.0486725663716814
136.04,2040,Single Family - Detached,1562,1545,17,0.0108834827144686
136.04,2045,Mobile Home,0,0,0,
136.04,2045,Multifamily,678,644,34,0.0501474926253687
136.04,2045,Single Family - Detached,1571,1553,18,0.011457670273711
136.04,2050,Mobile Home,0,0,0,
136.04,2050,Multifamily,678,644,34,0.0501474926253687
136.04,2050,Single Family - Detached,1574,1557,17,0.0108005082592122
136.05,2012,Mobile Home,0,0,0,
136.05,2012,Multifamily,359,337,22,0.0612813370473538
136.05,2012,Single Family - Detached,1768,1749,19,0.0107466063348416
136.05,2020,Mobile Home,0,0,0,
136.05,2020,Multifamily,359,338,21,0.0584958217270195
136.05,2020,Single Family - Detached,1768,1749,19,0.0107466063348416
136.05,2025,Mobile Home,0,0,0,
136.05,2025,Multifamily,359,341,18,0.0501392757660167
136.05,2025,Single Family - Detached,1974,1962,12,0.0060790273556231
136.05,2030,Mobile Home,0,0,0,
136.05,2030,Multifamily,359,341,18,0.0501392757660167
136.05,2030,Single Family - Detached,1975,1956,19,0.00962025316455696
136.05,2035,Mobile Home,0,0,0,
136.05,2035,Multifamily,359,343,16,0.0445682451253482
136.05,2035,Single Family - Detached,1975,1955,20,0.010126582278481
136.05,2040,Mobile Home,0,0,0,
136.05,2040,Multifamily,359,342,17,0.0473537604456825
136.05,2040,Single Family - Detached,1975,1949,26,0.0131645569620253
136.05,2045,Mobile Home,0,0,0,
136.05,2045,Multifamily,359,339,20,0.0557103064066852
136.05,2045,Single Family - Detached,1975,1943,32,0.0162025316455696
136.05,2050,Mobile Home,0,0,0,
136.05,2050,Multifamily,359,338,21,0.0584958217270195
136.05,2050,Single Family - Detached,1975,1942,33,0.0167088607594937
136.06,2012,Mobile Home,0,0,0,
136.06,2012,Multifamily,1873,1804,69,0.0368392952482648
136.06,2012,Single Family - Detached,958,908,50,0.0521920668058455
136.06,2020,Mobile Home,0,0,0,
136.06,2020,Multifamily,1737,1671,66,0.0379965457685665
136.06,2020,Single Family - Detached,958,908,50,0.0521920668058455
136.06,2025,Mobile Home,0,0,0,
136.06,2025,Multifamily,1690,1636,54,0.0319526627218935
136.06,2025,Single Family - Detached,959,923,36,0.0375391032325339
136.06,2030,Mobile Home,0,0,0,
136.06,2030,Multifamily,1642,1589,53,0.0322777101096224
136.06,2030,Single Family - Detached,959,922,37,0.0385818561001043
136.06,2035,Mobile Home,0,0,0,
136.06,2035,Multifamily,1591,1542,49,0.0307982401005657
136.06,2035,Single Family - Detached,959,922,37,0.0385818561001043
136.06,2040,Mobile Home,0,0,0,
136.06,2040,Multifamily,1591,1539,52,0.032683846637335
136.06,2040,Single Family - Detached,959,922,37,0.0385818561001043
136.06,2045,Mobile Home,0,0,0,
136.06,2045,Multifamily,1599,1545,54,0.0337711069418387
136.06,2045,Single Family - Detached,959,922,37,0.0385818561001043
136.06,2050,Mobile Home,0,0,0,
136.06,2050,Multifamily,1599,1545,54,0.0337711069418387
136.06,2050,Single Family - Detached,959,922,37,0.0385818561001043
137.01,2012,Mobile Home,0,0,0,
137.01,2012,Multifamily,109,108,1,0.00917431192660551
137.01,2012,Single Family - Detached,802,793,9,0.0112219451371571
137.01,2020,Mobile Home,0,0,0,
137.01,2020,Multifamily,104,100,4,0.0384615384615385
137.01,2020,Single Family - Detached,797,785,12,0.0150564617314931
137.01,2025,Mobile Home,0,0,0,
137.01,2025,Multifamily,104,101,3,0.0288461538461538
137.01,2025,Single Family - Detached,823,818,5,0.00607533414337789
137.01,2030,Mobile Home,0,0,0,
137.01,2030,Multifamily,104,101,3,0.0288461538461538
137.01,2030,Single Family - Detached,825,820,5,0.00606060606060606
137.01,2035,Mobile Home,0,0,0,
137.01,2035,Multifamily,104,101,3,0.0288461538461538
137.01,2035,Single Family - Detached,829,827,2,0.00241254523522316
137.01,2040,Mobile Home,0,0,0,
137.01,2040,Multifamily,105,103,2,0.019047619047619
137.01,2040,Single Family - Detached,850,847,3,0.00352941176470588
137.01,2045,Mobile Home,0,0,0,
137.01,2045,Multifamily,105,103,2,0.019047619047619
137.01,2045,Single Family - Detached,850,846,4,0.00470588235294118
137.01,2050,Mobile Home,0,0,0,
137.01,2050,Multifamily,105,103,2,0.019047619047619
137.01,2050,Single Family - Detached,851,847,4,0.00470035252643948
137.02,2012,Mobile Home,130,130,0,0
137.02,2012,Multifamily,544,541,3,0.00551470588235294
137.02,2012,Single Family - Detached,1036,981,55,0.0530888030888031
137.02,2020,Mobile Home,130,130,0,0
137.02,2020,Multifamily,536,517,19,0.0354477611940298
137.02,2020,Single Family - Detached,1103,1039,64,0.0580235720761559
137.02,2025,Mobile Home,130,130,0,0
137.02,2025,Multifamily,536,517,19,0.0354477611940298
137.02,2025,Single Family - Detached,1154,1123,31,0.0268630849220104
137.02,2030,Mobile Home,130,129,1,0.00769230769230769
137.02,2030,Multifamily,536,517,19,0.0354477611940298
137.02,2030,Single Family - Detached,1154,1117,37,0.0320623916811092
137.02,2035,Mobile Home,130,129,1,0.00769230769230769
137.02,2035,Multifamily,537,518,19,0.0353817504655493
137.02,2035,Single Family - Detached,1154,1117,37,0.0320623916811092
137.02,2040,Mobile Home,130,129,1,0.00769230769230769
137.02,2040,Multifamily,539,517,22,0.0408163265306122
137.02,2040,Single Family - Detached,1156,1101,55,0.0475778546712803
137.02,2045,Mobile Home,130,129,1,0.00769230769230769
137.02,2045,Multifamily,539,517,22,0.0408163265306122
137.02,2045,Single Family - Detached,1156,1068,88,0.0761245674740484
137.02,2050,Mobile Home,130,127,3,0.0230769230769231
137.02,2050,Multifamily,539,510,29,0.0538033395176252
137.02,2050,Single Family - Detached,1156,1061,95,0.0821799307958477
138.01,2012,Mobile Home,0,0,0,
138.01,2012,Multifamily,349,340,9,0.0257879656160458
138.01,2012,Single Family - Detached,1374,1348,26,0.0189228529839884
138.01,2020,Mobile Home,0,0,0,
138.01,2020,Multifamily,363,348,15,0.0413223140495868
138.01,2020,Single Family - Detached,1431,1404,27,0.0188679245283019
138.01,2025,Mobile Home,0,0,0,
138.01,2025,Multifamily,363,349,14,0.0385674931129477
138.01,2025,Single Family - Detached,1440,1416,24,0.0166666666666667
138.01,2030,Mobile Home,0,0,0,
138.01,2030,Multifamily,363,349,14,0.0385674931129477
138.01,2030,Single Family - Detached,1440,1416,24,0.0166666666666667
138.01,2035,Mobile Home,0,0,0,
138.01,2035,Multifamily,365,350,15,0.0410958904109589
138.01,2035,Single Family - Detached,1438,1417,21,0.0146036161335188
138.01,2040,Mobile Home,0,0,0,
138.01,2040,Multifamily,365,346,19,0.0520547945205479
138.01,2040,Single Family - Detached,1438,1410,28,0.019471488178025
138.01,2045,Mobile Home,0,0,0,
138.01,2045,Multifamily,365,345,20,0.0547945205479452
138.01,2045,Single Family - Detached,1438,1395,43,0.0299026425591099
138.01,2050,Mobile Home,0,0,0,
138.01,2050,Multifamily,368,341,27,0.0733695652173913
138.01,2050,Single Family - Detached,1438,1393,45,0.0312934631432545
138.02,2012,Mobile Home,140,92,48,0.342857142857143
138.02,2012,Multifamily,62,53,9,0.145161290322581
138.02,2012,Single Family - Detached,803,762,41,0.0510585305105853
138.02,2020,Mobile Home,140,93,47,0.335714285714286
138.02,2020,Multifamily,34,21,13,0.382352941176471
138.02,2020,Single Family - Detached,802,789,13,0.0162094763092269
138.02,2025,Mobile Home,140,93,47,0.335714285714286
138.02,2025,Multifamily,26,14,12,0.461538461538462
138.02,2025,Single Family - Detached,780,770,10,0.0128205128205128
138.02,2030,Mobile Home,140,92,48,0.342857142857143
138.02,2030,Multifamily,26,14,12,0.461538461538462
138.02,2030,Single Family - Detached,780,769,11,0.0141025641025641
138.02,2035,Mobile Home,140,92,48,0.342857142857143
138.02,2035,Multifamily,26,13,13,0.5
138.02,2035,Single Family - Detached,780,770,10,0.0128205128205128
138.02,2040,Mobile Home,140,93,47,0.335714285714286
138.02,2040,Multifamily,26,11,15,0.576923076923077
138.02,2040,Single Family - Detached,780,768,12,0.0153846153846154
138.02,2045,Mobile Home,140,92,48,0.342857142857143
138.02,2045,Multifamily,26,10,16,0.615384615384615
138.02,2045,Single Family - Detached,780,759,21,0.0269230769230769
138.02,2050,Mobile Home,140,89,51,0.364285714285714
138.02,2050,Multifamily,26,9,17,0.653846153846154
138.02,2050,Single Family - Detached,780,758,22,0.0282051282051282
139.03,2012,Mobile Home,0,0,0,
139.03,2012,Multifamily,115,308,-193,-1.67826086956522
139.03,2012,Single Family - Detached,1172,970,202,0.172354948805461
139.03,2020,Mobile Home,0,0,0,
139.03,2020,Multifamily,115,290,-175,-1.52173913043478
139.03,2020,Single Family - Detached,1172,952,220,0.187713310580205
139.03,2025,Mobile Home,0,0,0,
139.03,2025,Multifamily,115,290,-175,-1.52173913043478
139.03,2025,Single Family - Detached,1172,954,218,0.186006825938567
139.03,2030,Mobile Home,0,0,0,
139.03,2030,Multifamily,115,290,-175,-1.52173913043478
139.03,2030,Single Family - Detached,1172,951,221,0.188566552901024
139.03,2035,Mobile Home,0,0,0,
139.03,2035,Multifamily,115,288,-173,-1.50434782608696
139.03,2035,Single Family - Detached,1172,953,219,0.186860068259386
139.03,2040,Mobile Home,0,0,0,
139.03,2040,Multifamily,115,285,-170,-1.47826086956522
139.03,2040,Single Family - Detached,1172,935,237,0.20221843003413
139.03,2045,Mobile Home,0,0,0,
139.03,2045,Multifamily,115,285,-170,-1.47826086956522
139.03,2045,Single Family - Detached,1192,1024,168,0.140939597315436
139.03,2050,Mobile Home,0,0,0,
139.03,2050,Multifamily,91,266,-175,-1.92307692307692
139.03,2050,Single Family - Detached,1198,1027,171,0.142737896494157
139.05,2012,Mobile Home,0,0,0,
139.05,2012,Multifamily,0,0,0,
139.05,2012,Single Family - Detached,1214,1152,62,0.0510708401976936
139.05,2020,Mobile Home,0,0,0,
139.05,2020,Multifamily,0,0,0,
139.05,2020,Single Family - Detached,1214,1130,84,0.0691927512355848
139.05,2025,Mobile Home,0,0,0,
139.05,2025,Multifamily,0,0,0,
139.05,2025,Single Family - Detached,1214,1133,81,0.0667215815485997
139.05,2030,Mobile Home,0,0,0,
139.05,2030,Multifamily,0,0,0,
139.05,2030,Single Family - Detached,1214,1130,84,0.0691927512355848
139.05,2035,Mobile Home,0,0,0,
139.05,2035,Multifamily,0,0,0,
139.05,2035,Single Family - Detached,1214,1130,84,0.0691927512355848
139.05,2040,Mobile Home,0,0,0,
139.05,2040,Multifamily,0,0,0,
139.05,2040,Single Family - Detached,1319,1207,112,0.0849128127369219
139.05,2045,Mobile Home,0,0,0,
139.05,2045,Multifamily,0,0,0,
139.05,2045,Single Family - Detached,1440,1308,132,0.0916666666666667
139.05,2050,Mobile Home,0,0,0,
139.05,2050,Multifamily,0,0,0,
139.05,2050,Single Family - Detached,1444,1309,135,0.0934903047091413
139.06,2012,Mobile Home,210,210,0,0
139.06,2012,Multifamily,255,247,8,0.0313725490196078
139.06,2012,Single Family - Detached,1151,1069,82,0.0712423979148566
139.06,2020,Mobile Home,210,210,0,0
139.06,2020,Multifamily,255,237,18,0.0705882352941176
139.06,2020,Single Family - Detached,1314,1218,96,0.0730593607305936
139.06,2025,Mobile Home,210,209,1,0.00476190476190476
139.06,2025,Multifamily,255,237,18,0.0705882352941176
139.06,2025,Single Family - Detached,1743,1707,36,0.0206540447504303
139.06,2030,Mobile Home,210,208,2,0.00952380952380952
139.06,2030,Multifamily,255,237,18,0.0705882352941176
139.06,2030,Single Family - Detached,1748,1710,38,0.0217391304347826
139.06,2035,Mobile Home,210,209,1,0.00476190476190476
139.06,2035,Multifamily,255,237,18,0.0705882352941176
139.06,2035,Single Family - Detached,1748,1710,38,0.0217391304347826
139.06,2040,Mobile Home,210,210,0,0
139.06,2040,Multifamily,255,236,19,0.0745098039215686
139.06,2040,Single Family - Detached,1756,1706,50,0.0284738041002278
139.06,2045,Mobile Home,210,209,1,0.00476190476190476
139.06,2045,Multifamily,255,236,19,0.0745098039215686
139.06,2045,Single Family - Detached,1756,1685,71,0.0404328018223235
139.06,2050,Mobile Home,210,204,6,0.0285714285714286
139.06,2050,Multifamily,255,231,24,0.0941176470588235
139.06,2050,Single Family - Detached,1756,1683,73,0.0415717539863326
139.07,2012,Mobile Home,102,102,0,0
139.07,2012,Multifamily,844,773,71,0.0841232227488152
139.07,2012,Single Family - Detached,392,390,2,0.00510204081632653
139.07,2020,Mobile Home,102,102,0,0
139.07,2020,Multifamily,846,753,93,0.109929078014184
139.07,2020,Single Family - Detached,392,374,18,0.0459183673469388
139.07,2025,Mobile Home,102,102,0,0
139.07,2025,Multifamily,846,753,93,0.109929078014184
139.07,2025,Single Family - Detached,429,425,4,0.00932400932400932
139.07,2030,Mobile Home,102,101,1,0.00980392156862745
139.07,2030,Multifamily,846,753,93,0.109929078014184
139.07,2030,Single Family - Detached,425,415,10,0.0235294117647059
139.07,2035,Mobile Home,102,101,1,0.00980392156862745
139.07,2035,Multifamily,834,745,89,0.106714628297362
139.07,2035,Single Family - Detached,423,414,9,0.0212765957446809
139.07,2040,Mobile Home,102,101,1,0.00980392156862745
139.07,2040,Multifamily,766,686,80,0.10443864229765
139.07,2040,Single Family - Detached,462,437,25,0.0541125541125541
139.07,2045,Mobile Home,102,100,2,0.0196078431372549
139.07,2045,Multifamily,766,686,80,0.10443864229765
139.07,2045,Single Family - Detached,612,563,49,0.0800653594771242
139.07,2050,Mobile Home,102,98,4,0.0392156862745098
139.07,2050,Multifamily,766,681,85,0.110966057441253
139.07,2050,Single Family - Detached,612,560,52,0.0849673202614379
139.08,2012,Mobile Home,0,0,0,
139.08,2012,Multifamily,437,425,12,0.0274599542334096
139.08,2012,Single Family - Detached,687,639,48,0.0698689956331878
139.08,2020,Mobile Home,0,0,0,
139.08,2020,Multifamily,437,413,24,0.0549199084668192
139.08,2020,Single Family - Detached,687,628,59,0.0858806404657933
139.08,2025,Mobile Home,0,0,0,
139.08,2025,Multifamily,437,413,24,0.0549199084668192
139.08,2025,Single Family - Detached,688,629,59,0.0857558139534884
139.08,2030,Mobile Home,0,0,0,
139.08,2030,Multifamily,437,413,24,0.0549199084668192
139.08,2030,Single Family - Detached,692,634,58,0.0838150289017341
139.08,2035,Mobile Home,0,0,0,
139.08,2035,Multifamily,437,413,24,0.0549199084668192
139.08,2035,Single Family - Detached,692,634,58,0.0838150289017341
139.08,2040,Mobile Home,0,0,0,
139.08,2040,Multifamily,437,412,25,0.05720823798627
139.08,2040,Single Family - Detached,692,623,69,0.0997109826589595
139.08,2045,Mobile Home,0,0,0,
139.08,2045,Multifamily,437,412,25,0.05720823798627
139.08,2045,Single Family - Detached,694,624,70,0.100864553314121
139.08,2050,Mobile Home,0,0,0,
139.08,2050,Multifamily,389,373,16,0.0411311053984576
139.08,2050,Single Family - Detached,692,623,69,0.0997109826589595
139.09,2012,Mobile Home,180,179,1,0.00555555555555556
139.09,2012,Multifamily,68,68,0,0
139.09,2012,Single Family - Detached,1028,982,46,0.0447470817120623
139.09,2020,Mobile Home,180,180,0,0
139.09,2020,Multifamily,68,56,12,0.176470588235294
139.09,2020,Single Family - Detached,1028,967,61,0.0593385214007782
139.09,2025,Mobile Home,180,180,0,0
139.09,2025,Multifamily,68,55,13,0.191176470588235
139.09,2025,Single Family - Detached,1028,967,61,0.0593385214007782
139.09,2030,Mobile Home,180,180,0,0
139.09,2030,Multifamily,68,55,13,0.191176470588235
139.09,2030,Single Family - Detached,1028,967,61,0.0593385214007782
139.09,2035,Mobile Home,180,180,0,0
139.09,2035,Multifamily,68,54,14,0.205882352941176
139.09,2035,Single Family - Detached,1028,967,61,0.0593385214007782
139.09,2040,Mobile Home,180,180,0,0
139.09,2040,Multifamily,68,51,17,0.25
139.09,2040,Single Family - Detached,1028,952,76,0.0739299610894942
139.09,2045,Mobile Home,180,180,0,0
139.09,2045,Multifamily,68,51,17,0.25
139.09,2045,Single Family - Detached,1028,930,98,0.0953307392996109
139.09,2050,Mobile Home,180,178,2,0.0111111111111111
139.09,2050,Multifamily,4,0,4,1
139.09,2050,Single Family - Detached,1028,927,101,0.0982490272373541
14,2012,Mobile Home,0,0,0,
14,2012,Multifamily,634,610,24,0.0378548895899054
14,2012,Single Family - Detached,1042,983,59,0.0566218809980806
14,2020,Mobile Home,0,0,0,
14,2020,Multifamily,634,593,41,0.0646687697160883
14,2020,Single Family - Detached,1045,976,69,0.0660287081339713
14,2025,Mobile Home,0,0,0,
14,2025,Multifamily,634,605,29,0.0457413249211356
14,2025,Single Family - Detached,1045,983,62,0.0593301435406699
14,2030,Mobile Home,0,0,0,
14,2030,Multifamily,634,589,45,0.0709779179810726
14,2030,Single Family - Detached,1045,980,65,0.062200956937799
14,2035,Mobile Home,0,0,0,
14,2035,Multifamily,634,582,52,0.082018927444795
14,2035,Single Family - Detached,1045,981,64,0.061244019138756
14,2040,Mobile Home,0,0,0,
14,2040,Multifamily,634,567,67,0.105678233438486
14,2040,Single Family - Detached,1045,979,66,0.0631578947368421
14,2045,Mobile Home,0,0,0,
14,2045,Multifamily,634,541,93,0.146687697160883
14,2045,Single Family - Detached,1045,976,69,0.0660287081339713
14,2050,Mobile Home,0,0,0,
14,2050,Multifamily,1205,1110,95,0.0788381742738589
14,2050,Single Family - Detached,999,933,66,0.0660660660660661
140.01,2012,Mobile Home,0,0,0,
140.01,2012,Multifamily,108,106,2,0.0185185185185185
140.01,2012,Single Family - Detached,1492,1446,46,0.0308310991957105
140.01,2020,Mobile Home,0,0,0,
140.01,2020,Multifamily,108,105,3,0.0277777777777778
140.01,2020,Single Family - Detached,1496,1450,46,0.0307486631016043
140.01,2025,Mobile Home,0,0,0,
140.01,2025,Multifamily,108,106,2,0.0185185185185185
140.01,2025,Single Family - Detached,1496,1458,38,0.0254010695187166
140.01,2030,Mobile Home,0,0,0,
140.01,2030,Multifamily,109,105,4,0.036697247706422
140.01,2030,Single Family - Detached,1496,1461,35,0.0233957219251337
140.01,2035,Mobile Home,0,0,0,
140.01,2035,Multifamily,111,106,5,0.045045045045045
140.01,2035,Single Family - Detached,1496,1464,32,0.0213903743315508
140.01,2040,Mobile Home,0,0,0,
140.01,2040,Multifamily,116,109,7,0.0603448275862069
140.01,2040,Single Family - Detached,1496,1464,32,0.0213903743315508
140.01,2045,Mobile Home,0,0,0,
140.01,2045,Multifamily,116,107,9,0.0775862068965517
140.01,2045,Single Family - Detached,1496,1457,39,0.0260695187165775
140.01,2050,Mobile Home,0,0,0,
140.01,2050,Multifamily,116,106,10,0.0862068965517241
140.01,2050,Single Family - Detached,1497,1469,28,0.0187040748162993
140.02,2012,Mobile Home,11,6,5,0.454545454545455
140.02,2012,Multifamily,8,8,0,0
140.02,2012,Single Family - Detached,1255,1244,11,0.00876494023904383
140.02,2020,Mobile Home,11,7,4,0.363636363636364
140.02,2020,Multifamily,8,8,0,0
140.02,2020,Single Family - Detached,1270,1257,13,0.0102362204724409
140.02,2025,Mobile Home,11,6,5,0.454545454545455
140.02,2025,Multifamily,8,8,0,0
140.02,2025,Single Family - Detached,1270,1256,14,0.0110236220472441
140.02,2030,Mobile Home,11,7,4,0.363636363636364
140.02,2030,Multifamily,8,8,0,0
140.02,2030,Single Family - Detached,1286,1269,17,0.0132192846034215
140.02,2035,Mobile Home,11,8,3,0.272727272727273
140.02,2035,Multifamily,8,8,0,0
140.02,2035,Single Family - Detached,1299,1285,14,0.0107775211701309
140.02,2040,Mobile Home,11,8,3,0.272727272727273
140.02,2040,Multifamily,8,8,0,0
140.02,2040,Single Family - Detached,1299,1280,19,0.014626635873749
140.02,2045,Mobile Home,11,7,4,0.363636363636364
140.02,2045,Multifamily,8,8,0,0
140.02,2045,Single Family - Detached,1299,1273,26,0.0200153964588145
140.02,2050,Mobile Home,11,7,4,0.363636363636364
140.02,2050,Multifamily,8,8,0,0
140.02,2050,Single Family - Detached,1299,1272,27,0.0207852193995381
141.01,2012,Mobile Home,0,0,0,
141.01,2012,Multifamily,24,24,0,0
141.01,2012,Single Family - Detached,1161,1119,42,0.0361757105943152
141.01,2020,Mobile Home,0,0,0,
141.01,2020,Multifamily,24,24,0,0
141.01,2020,Single Family - Detached,1161,1115,46,0.0396210163652024
141.01,2025,Mobile Home,0,0,0,
141.01,2025,Multifamily,24,24,0,0
141.01,2025,Single Family - Detached,1164,1120,44,0.0378006872852234
141.01,2030,Mobile Home,0,0,0,
141.01,2030,Multifamily,24,24,0,0
141.01,2030,Single Family - Detached,1170,1122,48,0.041025641025641
141.01,2035,Mobile Home,0,0,0,
141.01,2035,Multifamily,24,24,0,0
141.01,2035,Single Family - Detached,1171,1127,44,0.0375747224594364
141.01,2040,Mobile Home,0,0,0,
141.01,2040,Multifamily,24,24,0,0
141.01,2040,Single Family - Detached,1171,1124,47,0.040136635354398
141.01,2045,Mobile Home,0,0,0,
141.01,2045,Multifamily,24,24,0,0
141.01,2045,Single Family - Detached,1171,1122,49,0.0418445772843723
141.01,2050,Mobile Home,0,0,0,
141.01,2050,Multifamily,24,24,0,0
141.01,2050,Single Family - Detached,1171,1122,49,0.0418445772843723
141.02,2012,Mobile Home,0,0,0,
141.02,2012,Multifamily,47,45,2,0.0425531914893617
141.02,2012,Single Family - Detached,1064,1032,32,0.0300751879699248
141.02,2020,Mobile Home,0,0,0,
141.02,2020,Multifamily,47,47,0,0
141.02,2020,Single Family - Detached,1064,1026,38,0.0357142857142857
141.02,2025,Mobile Home,0,0,0,
141.02,2025,Multifamily,49,49,0,0
141.02,2025,Single Family - Detached,1112,1088,24,0.0215827338129496
141.02,2030,Mobile Home,0,0,0,
141.02,2030,Multifamily,49,49,0,0
141.02,2030,Single Family - Detached,1128,1099,29,0.025709219858156
141.02,2035,Mobile Home,0,0,0,
141.02,2035,Multifamily,49,49,0,0
141.02,2035,Single Family - Detached,1133,1105,28,0.0247131509267432
141.02,2040,Mobile Home,0,0,0,
141.02,2040,Multifamily,49,48,1,0.0204081632653061
141.02,2040,Single Family - Detached,1133,1103,30,0.0264783759929391
141.02,2045,Mobile Home,0,0,0,
141.02,2045,Multifamily,49,48,1,0.0204081632653061
141.02,2045,Single Family - Detached,1133,1101,32,0.028243601059135
141.02,2050,Mobile Home,0,0,0,
141.02,2050,Multifamily,49,48,1,0.0204081632653061
141.02,2050,Single Family - Detached,1133,1101,32,0.028243601059135
142,2012,Mobile Home,0,0,0,
142,2012,Multifamily,0,0,0,
142,2012,Single Family - Detached,1971,1909,62,0.0314561136478945
142,2020,Mobile Home,0,0,0,
142,2020,Multifamily,0,0,0,
142,2020,Single Family - Detached,2065,1999,66,0.0319612590799031
142,2025,Mobile Home,0,0,0,
142,2025,Multifamily,0,0,0,
142,2025,Single Family - Detached,2093,2041,52,0.0248447204968944
142,2030,Mobile Home,0,0,0,
142,2030,Multifamily,0,0,0,
142,2030,Single Family - Detached,2107,2062,45,0.0213573801613669
142,2035,Mobile Home,0,0,0,
142,2035,Multifamily,0,0,0,
142,2035,Single Family - Detached,2111,2067,44,0.0208432022738039
142,2040,Mobile Home,0,0,0,
142,2040,Multifamily,34,34,0,0
142,2040,Single Family - Detached,2111,2067,44,0.0208432022738039
142,2045,Mobile Home,0,0,0,
142,2045,Multifamily,34,34,0,0
142,2045,Single Family - Detached,2120,2076,44,0.0207547169811321
142,2050,Mobile Home,0,0,0,
142,2050,Multifamily,34,34,0,0
142,2050,Single Family - Detached,2120,2076,44,0.0207547169811321
143,2012,Mobile Home,0,0,0,
143,2012,Multifamily,231,231,0,0
143,2012,Single Family - Detached,1046,1009,37,0.0353728489483748
143,2020,Mobile Home,0,0,0,
143,2020,Multifamily,279,271,8,0.028673835125448
143,2020,Single Family - Detached,1033,996,37,0.0358180058083253
143,2025,Mobile Home,0,0,0,
143,2025,Multifamily,282,275,7,0.024822695035461
143,2025,Single Family - Detached,1033,999,34,0.0329138431752178
143,2030,Mobile Home,0,0,0,
143,2030,Multifamily,312,305,7,0.0224358974358974
143,2030,Single Family - Detached,1020,987,33,0.0323529411764706
143,2035,Mobile Home,0,0,0,
143,2035,Multifamily,360,348,12,0.0333333333333333
143,2035,Single Family - Detached,1023,992,31,0.0303030303030303
143,2040,Mobile Home,0,0,0,
143,2040,Multifamily,360,342,18,0.05
143,2040,Single Family - Detached,1023,992,31,0.0303030303030303
143,2045,Mobile Home,0,0,0,
143,2045,Multifamily,424,398,26,0.0613207547169811
143,2045,Single Family - Detached,1026,1013,13,0.0126705653021442
143,2050,Mobile Home,0,0,0,
143,2050,Multifamily,440,409,31,0.0704545454545455
143,2050,Single Family - Detached,1026,1008,18,0.0175438596491228
144,2012,Mobile Home,36,22,14,0.388888888888889
144,2012,Multifamily,1273,1163,110,0.0864100549882168
144,2012,Single Family - Detached,299,319,-20,-0.0668896321070234
144,2020,Mobile Home,36,23,13,0.361111111111111
144,2020,Multifamily,1506,1388,118,0.0783532536520584
144,2020,Single Family - Detached,221,235,-14,-0.0633484162895928
144,2025,Mobile Home,36,22,14,0.388888888888889
144,2025,Multifamily,1640,1529,111,0.0676829268292683
144,2025,Single Family - Detached,197,215,-18,-0.0913705583756345
144,2030,Mobile Home,36,22,14,0.388888888888889
144,2030,Multifamily,1897,1770,127,0.0669478123352662
144,2030,Single Family - Detached,187,200,-13,-0.0695187165775401
144,2035,Mobile Home,36,23,13,0.361111111111111
144,2035,Multifamily,1919,1802,117,0.0609692548202189
144,2035,Single Family - Detached,183,196,-13,-0.0710382513661202
144,2040,Mobile Home,0,0,0,
144,2040,Multifamily,2291,2152,139,0.0606721955477957
144,2040,Single Family - Detached,170,176,-6,-0.0352941176470588
144,2045,Mobile Home,0,0,0,
144,2045,Multifamily,2380,2233,147,0.0617647058823529
144,2045,Single Family - Detached,150,140,10,0.0666666666666667
144,2050,Mobile Home,0,0,0,
144,2050,Multifamily,2725,2557,168,0.061651376146789
144,2050,Single Family - Detached,150,133,17,0.113333333333333
145,2012,Mobile Home,0,0,0,
145,2012,Multifamily,436,432,4,0.00917431192660551
145,2012,Single Family - Detached,992,974,18,0.0181451612903226
145,2020,Mobile Home,0,0,0,
145,2020,Multifamily,459,454,5,0.0108932461873638
145,2020,Single Family - Detached,1046,1029,17,0.0162523900573614
145,2025,Mobile Home,0,0,0,
145,2025,Multifamily,512,506,6,0.01171875
145,2025,Single Family - Detached,1046,1033,13,0.0124282982791587
145,2030,Mobile Home,0,0,0,
145,2030,Multifamily,761,750,11,0.0144546649145861
145,2030,Single Family - Detached,1044,1031,13,0.0124521072796935
145,2035,Mobile Home,0,0,0,
145,2035,Multifamily,761,748,13,0.0170827858081472
145,2035,Single Family - Detached,1044,1031,13,0.0124521072796935
145,2040,Mobile Home,0,0,0,
145,2040,Multifamily,761,746,15,0.0197109067017083
145,2040,Single Family - Detached,1044,1029,15,0.014367816091954
145,2045,Mobile Home,0,0,0,
145,2045,Multifamily,761,744,17,0.0223390275952694
145,2045,Single Family - Detached,1044,1026,18,0.0172413793103448
145,2050,Mobile Home,0,0,0,
145,2050,Multifamily,761,742,19,0.0249671484888305
145,2050,Single Family - Detached,1044,1024,20,0.0191570881226054
146.01,2012,Mobile Home,0,0,0,
146.01,2012,Multifamily,1341,1339,2,0.00149142431021626
146.01,2012,Single Family - Detached,720,710,10,0.0138888888888889
146.01,2020,Mobile Home,0,0,0,
146.01,2020,Multifamily,1697,1687,10,0.00589275191514437
146.01,2020,Single Family - Detached,723,703,20,0.0276625172890733
146.01,2025,Mobile Home,0,0,0,
146.01,2025,Multifamily,1697,1688,9,0.00530347672362994
146.01,2025,Single Family - Detached,723,716,7,0.00968188105117566
146.01,2030,Mobile Home,0,0,0,
146.01,2030,Multifamily,1698,1688,10,0.00588928150765607
146.01,2030,Single Family - Detached,718,713,5,0.00696378830083565
146.01,2035,Mobile Home,0,0,0,
146.01,2035,Multifamily,2074,2053,21,0.0101253616200579
146.01,2035,Single Family - Detached,696,693,3,0.00431034482758621
146.01,2040,Mobile Home,0,0,0,
146.01,2040,Multifamily,2787,2754,33,0.0118406889128095
146.01,2040,Single Family - Detached,674,666,8,0.0118694362017804
146.01,2045,Mobile Home,0,0,0,
146.01,2045,Multifamily,2787,2752,35,0.0125583064226767
146.01,2045,Single Family - Detached,674,658,16,0.0237388724035608
146.01,2050,Mobile Home,0,0,0,
146.01,2050,Multifamily,2787,2750,37,0.013275923932544
146.01,2050,Single Family - Detached,674,657,17,0.0252225519287834
146.02,2012,Mobile Home,0,0,0,
146.02,2012,Multifamily,231,231,0,0
146.02,2012,Single Family - Detached,1650,1598,52,0.0315151515151515
146.02,2020,Mobile Home,0,0,0,
146.02,2020,Multifamily,231,231,0,0
146.02,2020,Single Family - Detached,1653,1600,53,0.0320629159104658
146.02,2025,Mobile Home,0,0,0,
146.02,2025,Multifamily,231,231,0,0
146.02,2025,Single Family - Detached,1653,1605,48,0.029038112522686
146.02,2030,Mobile Home,0,0,0,
146.02,2030,Multifamily,231,231,0,0
146.02,2030,Single Family - Detached,1657,1609,48,0.0289680144840072
146.02,2035,Mobile Home,0,0,0,
146.02,2035,Multifamily,231,227,4,0.0173160173160173
146.02,2035,Single Family - Detached,1692,1660,32,0.0189125295508274
146.02,2040,Mobile Home,0,0,0,
146.02,2040,Multifamily,240,234,6,0.025
146.02,2040,Single Family - Detached,1692,1658,34,0.0200945626477541
146.02,2045,Mobile Home,0,0,0,
146.02,2045,Multifamily,241,229,12,0.0497925311203319
146.02,2045,Single Family - Detached,1752,1709,43,0.0245433789954338
146.02,2050,Mobile Home,0,0,0,
146.02,2050,Multifamily,282,266,16,0.0567375886524823
146.02,2050,Single Family - Detached,1752,1707,45,0.0256849315068493
147,2012,Mobile Home,0,0,0,
147,2012,Multifamily,846,791,55,0.0650118203309693
147,2012,Single Family - Detached,2442,2381,61,0.024979524979525
147,2020,Mobile Home,0,0,0,
147,2020,Multifamily,830,779,51,0.0614457831325301
147,2020,Single Family - Detached,2475,2408,67,0.0270707070707071
147,2025,Mobile Home,0,0,0,
147,2025,Multifamily,850,798,52,0.0611764705882353
147,2025,Single Family - Detached,2463,2407,56,0.0227365002030045
147,2030,Mobile Home,0,0,0,
147,2030,Multifamily,1444,1385,59,0.0408587257617729
147,2030,Single Family - Detached,2467,2411,56,0.0226996351844345
147,2035,Mobile Home,0,0,0,
147,2035,Multifamily,1793,1771,22,0.0122699386503067
147,2035,Single Family - Detached,2463,2407,56,0.0227365002030045
147,2040,Mobile Home,0,0,0,
147,2040,Multifamily,1906,1877,29,0.0152151101783841
147,2040,Single Family - Detached,2459,2402,57,0.0231801545343636
147,2045,Mobile Home,0,0,0,
147,2045,Multifamily,1906,1871,35,0.0183630640083945
147,2045,Single Family - Detached,2459,2395,64,0.0260268401789345
147,2050,Mobile Home,0,0,0,
147,2050,Multifamily,1924,1882,42,0.0218295218295218
147,2050,Single Family - Detached,2459,2394,65,0.0264335095567304
148.03,2012,Mobile Home,0,0,0,
148.03,2012,Multifamily,1820,1724,96,0.0527472527472527
148.03,2012,Single Family - Detached,688,696,-8,-0.0116279069767442
148.03,2020,Mobile Home,0,0,0,
148.03,2020,Multifamily,1820,1721,99,0.0543956043956044
148.03,2020,Single Family - Detached,690,692,-2,-0.00289855072463768
148.03,2025,Mobile Home,0,0,0,
148.03,2025,Multifamily,1820,1732,88,0.0483516483516484
148.03,2025,Single Family - Detached,690,693,-3,-0.00434782608695652
148.03,2030,Mobile Home,0,0,0,
148.03,2030,Multifamily,1820,1727,93,0.0510989010989011
148.03,2030,Single Family - Detached,690,688,2,0.00289855072463768
148.03,2035,Mobile Home,0,0,0,
148.03,2035,Multifamily,1828,1716,112,0.0612691466083151
148.03,2035,Single Family - Detached,690,688,2,0.00289855072463768
148.03,2040,Mobile Home,0,0,0,
148.03,2040,Multifamily,1828,1703,125,0.0683807439824945
148.03,2040,Single Family - Detached,690,687,3,0.00434782608695652
148.03,2045,Mobile Home,0,0,0,
148.03,2045,Multifamily,1830,1702,128,0.0699453551912568
148.03,2045,Single Family - Detached,690,686,4,0.00579710144927536
148.03,2050,Mobile Home,0,0,0,
148.03,2050,Multifamily,1836,1712,124,0.0675381263616558
148.03,2050,Single Family - Detached,690,686,4,0.00579710144927536
148.04,2012,Mobile Home,0,0,0,
148.04,2012,Multifamily,1359,1304,55,0.0404709345106696
148.04,2012,Single Family - Detached,850,843,7,0.00823529411764706
148.04,2020,Mobile Home,0,0,0,
148.04,2020,Multifamily,1374,1314,60,0.0436681222707424
148.04,2020,Single Family - Detached,852,841,11,0.0129107981220657
148.04,2025,Mobile Home,0,0,0,
148.04,2025,Multifamily,1374,1324,50,0.0363901018922853
148.04,2025,Single Family - Detached,852,845,7,0.00821596244131455
148.04,2030,Mobile Home,0,0,0,
148.04,2030,Multifamily,1374,1324,50,0.0363901018922853
148.04,2030,Single Family - Detached,852,839,13,0.0152582159624413
148.04,2035,Mobile Home,0,0,0,
148.04,2035,Multifamily,1383,1325,58,0.0419378163412871
148.04,2035,Single Family - Detached,852,841,11,0.0129107981220657
148.04,2040,Mobile Home,0,0,0,
148.04,2040,Multifamily,1391,1358,33,0.0237239396117901
148.04,2040,Single Family - Detached,852,839,13,0.0152582159624413
148.04,2045,Mobile Home,0,0,0,
148.04,2045,Multifamily,1398,1361,37,0.0264663805436338
148.04,2045,Single Family - Detached,852,839,13,0.0152582159624413
148.04,2050,Mobile Home,0,0,0,
148.04,2050,Multifamily,1398,1355,43,0.030758226037196
148.04,2050,Single Family - Detached,852,839,13,0.0152582159624413
148.05,2012,Mobile Home,52,52,0,0
148.05,2012,Multifamily,1205,1200,5,0.004149377593361
148.05,2012,Single Family - Detached,861,819,42,0.0487804878048781
148.05,2020,Mobile Home,52,44,8,0.153846153846154
148.05,2020,Multifamily,1403,1385,18,0.0128296507483963
148.05,2020,Single Family - Detached,870,831,39,0.0448275862068966
148.05,2025,Mobile Home,52,44,8,0.153846153846154
148.05,2025,Multifamily,1405,1395,10,0.00711743772241993
148.05,2025,Single Family - Detached,893,878,15,0.0167973124300112
148.05,2030,Mobile Home,0,0,0,
148.05,2030,Multifamily,1467,1453,14,0.00954328561690525
148.05,2030,Single Family - Detached,893,877,16,0.0179171332586786
148.05,2035,Mobile Home,0,0,0,
148.05,2035,Multifamily,1473,1439,34,0.023082145281738
148.05,2035,Single Family - Detached,893,877,16,0.0179171332586786
148.05,2040,Mobile Home,0,0,0,
148.05,2040,Multifamily,1473,1426,47,0.031907671418873
148.05,2040,Single Family - Detached,893,876,17,0.019036954087346
148.05,2045,Mobile Home,0,0,0,
148.05,2045,Multifamily,1473,1423,50,0.0339443312966735
148.05,2045,Single Family - Detached,893,875,18,0.0201567749160134
148.05,2050,Mobile Home,0,0,0,
148.05,2050,Multifamily,1473,1415,58,0.0393754243041412
148.05,2050,Single Family - Detached,893,875,18,0.0201567749160134
148.06,2012,Mobile Home,280,208,72,0.257142857142857
148.06,2012,Multifamily,924,919,5,0.00541125541125541
148.06,2012,Single Family - Detached,200,190,10,0.05
148.06,2020,Mobile Home,105,78,27,0.257142857142857
148.06,2020,Multifamily,923,916,7,0.0075839653304442
148.06,2020,Single Family - Detached,193,176,17,0.0880829015544041
148.06,2025,Mobile Home,71,52,19,0.267605633802817
148.06,2025,Multifamily,1076,1076,0,0
148.06,2025,Single Family - Detached,196,184,12,0.0612244897959184
148.06,2030,Mobile Home,0,0,0,
148.06,2030,Multifamily,1989,1952,37,0.0186023127199598
148.06,2030,Single Family - Detached,196,177,19,0.0969387755102041
148.06,2035,Mobile Home,0,0,0,
148.06,2035,Multifamily,2111,2034,77,0.0364756039791568
148.06,2035,Single Family - Detached,196,179,17,0.086734693877551
148.06,2040,Mobile Home,0,0,0,
148.06,2040,Multifamily,2191,2082,109,0.0497489730716568
148.06,2040,Single Family - Detached,196,176,20,0.102040816326531
148.06,2045,Mobile Home,0,0,0,
148.06,2045,Multifamily,2191,2073,118,0.0538566864445459
148.06,2045,Single Family - Detached,196,174,22,0.112244897959184
148.06,2050,Mobile Home,0,0,0,
148.06,2050,Multifamily,2191,2053,138,0.0629849383842994
148.06,2050,Single Family - Detached,196,174,22,0.112244897959184
149.01,2012,Mobile Home,0,0,0,
149.01,2012,Multifamily,837,819,18,0.021505376344086
149.01,2012,Single Family - Detached,1063,1049,14,0.013170272812794
149.01,2020,Mobile Home,0,0,0,
149.01,2020,Multifamily,837,819,18,0.021505376344086
149.01,2020,Single Family - Detached,1108,1092,16,0.0144404332129964
149.01,2025,Mobile Home,0,0,0,
149.01,2025,Multifamily,837,821,16,0.019115890083632
149.01,2025,Single Family - Detached,1108,1098,10,0.00902527075812274
149.01,2030,Mobile Home,0,0,0,
149.01,2030,Multifamily,837,819,18,0.021505376344086
149.01,2030,Single Family - Detached,1108,1097,11,0.00992779783393502
149.01,2035,Mobile Home,0,0,0,
149.01,2035,Multifamily,837,811,26,0.031063321385902
149.01,2035,Single Family - Detached,1108,1097,11,0.00992779783393502
149.01,2040,Mobile Home,0,0,0,
149.01,2040,Multifamily,837,803,34,0.040621266427718
149.01,2040,Single Family - Detached,1108,1095,13,0.0117328519855596
149.01,2045,Mobile Home,0,0,0,
149.01,2045,Multifamily,843,801,42,0.0498220640569395
149.01,2045,Single Family - Detached,1143,1130,13,0.0113735783027122
149.01,2050,Mobile Home,0,0,0,
149.01,2050,Multifamily,1014,963,51,0.0502958579881657
149.01,2050,Single Family - Detached,1143,1129,14,0.0122484689413823
149.02,2012,Mobile Home,0,0,0,
149.02,2012,Multifamily,754,732,22,0.0291777188328912
149.02,2012,Single Family - Detached,775,714,61,0.0787096774193548
149.02,2020,Mobile Home,0,0,0,
149.02,2020,Multifamily,754,729,25,0.0331564986737401
149.02,2020,Single Family - Detached,775,704,71,0.0916129032258065
149.02,2025,Mobile Home,0,0,0,
149.02,2025,Multifamily,754,743,11,0.0145888594164456
149.02,2025,Single Family - Detached,775,716,59,0.0761290322580645
149.02,2030,Mobile Home,0,0,0,
149.02,2030,Multifamily,754,740,14,0.0185676392572944
149.02,2030,Single Family - Detached,775,711,64,0.0825806451612903
149.02,2035,Mobile Home,0,0,0,
149.02,2035,Multifamily,754,725,29,0.0384615384615385
149.02,2035,Single Family - Detached,778,714,64,0.0822622107969152
149.02,2040,Mobile Home,0,0,0,
149.02,2040,Multifamily,951,914,37,0.0389064143007361
149.02,2040,Single Family - Detached,765,694,71,0.0928104575163399
149.02,2045,Mobile Home,0,0,0,
149.02,2045,Multifamily,1558,1520,38,0.024390243902439
149.02,2045,Single Family - Detached,742,673,69,0.0929919137466307
149.02,2050,Mobile Home,0,0,0,
149.02,2050,Multifamily,2229,2186,43,0.0192911619560341
149.02,2050,Single Family - Detached,732,664,68,0.092896174863388
15,2012,Mobile Home,0,0,0,
15,2012,Multifamily,692,670,22,0.0317919075144509
15,2012,Single Family - Detached,1268,1238,30,0.0236593059936909
15,2020,Mobile Home,0,0,0,
15,2020,Multifamily,692,655,37,0.0534682080924856
15,2020,Single Family - Detached,1282,1247,35,0.0273010920436817
15,2025,Mobile Home,0,0,0,
15,2025,Multifamily,692,664,28,0.0404624277456647
15,2025,Single Family - Detached,1282,1252,30,0.0234009360374415
15,2030,Mobile Home,0,0,0,
15,2030,Multifamily,692,651,41,0.0592485549132948
15,2030,Single Family - Detached,1282,1250,32,0.0249609984399376
15,2035,Mobile Home,0,0,0,
15,2035,Multifamily,692,647,45,0.065028901734104
15,2035,Single Family - Detached,1282,1252,30,0.0234009360374415
15,2040,Mobile Home,0,0,0,
15,2040,Multifamily,692,634,58,0.0838150289017341
15,2040,Single Family - Detached,1283,1251,32,0.0249415432579891
15,2045,Mobile Home,0,0,0,
15,2045,Multifamily,692,607,85,0.122832369942197
15,2045,Single Family - Detached,1283,1249,34,0.0265003897116134
15,2050,Mobile Home,0,0,0,
15,2050,Multifamily,1309,1209,100,0.0763941940412529
15,2050,Single Family - Detached,1168,1140,28,0.023972602739726
150,2012,Mobile Home,0,0,0,
150,2012,Multifamily,1547,1370,177,0.114414996767938
150,2012,Single Family - Detached,1231,1173,58,0.0471161657189277
150,2020,Mobile Home,0,0,0,
150,2020,Multifamily,1605,1425,180,0.11214953271028
150,2020,Single Family - Detached,1231,1171,60,0.0487408610885459
150,2025,Mobile Home,0,0,0,
150,2025,Multifamily,1605,1430,175,0.109034267912773
150,2025,Single Family - Detached,1237,1175,62,0.0501212611156023
150,2030,Mobile Home,0,0,0,
150,2030,Multifamily,1605,1430,175,0.109034267912773
150,2030,Single Family - Detached,1255,1211,44,0.0350597609561753
150,2035,Mobile Home,0,0,0,
150,2035,Multifamily,2310,2215,95,0.0411255411255411
150,2035,Single Family - Detached,1255,1211,44,0.0350597609561753
150,2040,Mobile Home,0,0,0,
150,2040,Multifamily,2150,2063,87,0.0404651162790698
150,2040,Single Family - Detached,1255,1210,45,0.0358565737051793
150,2045,Mobile Home,0,0,0,
150,2045,Multifamily,2073,1984,89,0.0429329474191992
150,2045,Single Family - Detached,1255,1209,46,0.0366533864541833
150,2050,Mobile Home,0,0,0,
150,2050,Multifamily,3061,2946,115,0.0375694217575956
150,2050,Single Family - Detached,1255,1209,46,0.0366533864541833
151,2012,Mobile Home,0,0,0,
151,2012,Multifamily,468,462,6,0.0128205128205128
151,2012,Single Family - Detached,1554,1521,33,0.0212355212355212
151,2020,Mobile Home,0,0,0,
151,2020,Multifamily,468,462,6,0.0128205128205128
151,2020,Single Family - Detached,1556,1523,33,0.0212082262210797
151,2025,Mobile Home,0,0,0,
151,2025,Multifamily,468,463,5,0.0106837606837607
151,2025,Single Family - Detached,1556,1523,33,0.0212082262210797
151,2030,Mobile Home,0,0,0,
151,2030,Multifamily,468,463,5,0.0106837606837607
151,2030,Single Family - Detached,1559,1524,35,0.0224502886465683
151,2035,Mobile Home,0,0,0,
151,2035,Multifamily,468,459,9,0.0192307692307692
151,2035,Single Family - Detached,1559,1524,35,0.0224502886465683
151,2040,Mobile Home,0,0,0,
151,2040,Multifamily,468,455,13,0.0277777777777778
151,2040,Single Family - Detached,1559,1524,35,0.0224502886465683
151,2045,Mobile Home,0,0,0,
151,2045,Multifamily,468,454,14,0.0299145299145299
151,2045,Single Family - Detached,1559,1524,35,0.0224502886465683
151,2050,Mobile Home,0,0,0,
151,2050,Multifamily,468,451,17,0.0363247863247863
151,2050,Single Family - Detached,1559,1524,35,0.0224502886465683
152,2012,Mobile Home,0,0,0,
152,2012,Multifamily,0,0,0,
152,2012,Single Family - Detached,1541,1505,36,0.0233614536015574
152,2020,Mobile Home,0,0,0,
152,2020,Multifamily,0,0,0,
152,2020,Single Family - Detached,1565,1524,41,0.0261980830670927
152,2025,Mobile Home,0,0,0,
152,2025,Multifamily,0,0,0,
152,2025,Single Family - Detached,1599,1572,27,0.0168855534709193
152,2030,Mobile Home,0,0,0,
152,2030,Multifamily,0,0,0,
152,2030,Single Family - Detached,1602,1572,30,0.0187265917602996
152,2035,Mobile Home,0,0,0,
152,2035,Multifamily,0,0,0,
152,2035,Single Family - Detached,1602,1575,27,0.0168539325842697
152,2040,Mobile Home,0,0,0,
152,2040,Multifamily,0,0,0,
152,2040,Single Family - Detached,1610,1572,38,0.0236024844720497
152,2045,Mobile Home,0,0,0,
152,2045,Multifamily,0,0,0,
152,2045,Single Family - Detached,1610,1565,45,0.0279503105590062
152,2050,Mobile Home,0,0,0,
152,2050,Multifamily,0,0,0,
152,2050,Single Family - Detached,1611,1564,47,0.0291744258224705
153.01,2012,Mobile Home,0,0,0,
153.01,2012,Multifamily,475,456,19,0.04
153.01,2012,Single Family - Detached,590,576,14,0.023728813559322
153.01,2020,Mobile Home,0,0,0,
153.01,2020,Multifamily,475,456,19,0.04
153.01,2020,Single Family - Detached,590,576,14,0.023728813559322
153.01,2025,Mobile Home,0,0,0,
153.01,2025,Multifamily,475,456,19,0.04
153.01,2025,Single Family - Detached,590,576,14,0.023728813559322
153.01,2030,Mobile Home,0,0,0,
153.01,2030,Multifamily,475,456,19,0.04
153.01,2030,Single Family - Detached,590,576,14,0.023728813559322
153.01,2035,Mobile Home,0,0,0,
153.01,2035,Multifamily,475,456,19,0.04
153.01,2035,Single Family - Detached,590,576,14,0.023728813559322
153.01,2040,Mobile Home,0,0,0,
153.01,2040,Multifamily,475,453,22,0.0463157894736842
153.01,2040,Single Family - Detached,590,576,14,0.023728813559322
153.01,2045,Mobile Home,0,0,0,
153.01,2045,Multifamily,475,451,24,0.0505263157894737
153.01,2045,Single Family - Detached,590,576,14,0.023728813559322
153.01,2050,Mobile Home,0,0,0,
153.01,2050,Multifamily,475,449,26,0.0547368421052632
153.01,2050,Single Family - Detached,590,576,14,0.023728813559322
153.02,2012,Mobile Home,170,170,0,0
153.02,2012,Multifamily,145,144,1,0.00689655172413793
153.02,2012,Single Family - Detached,1150,1104,46,0.04
153.02,2020,Mobile Home,170,170,0,0
153.02,2020,Multifamily,145,144,1,0.00689655172413793
153.02,2020,Single Family - Detached,1170,1121,49,0.0418803418803419
153.02,2025,Mobile Home,170,170,0,0
153.02,2025,Multifamily,145,145,0,0
153.02,2025,Single Family - Detached,1177,1131,46,0.0390824129141886
153.02,2030,Mobile Home,170,169,1,0.00588235294117647
153.02,2030,Multifamily,145,145,0,0
153.02,2030,Single Family - Detached,1186,1140,46,0.0387858347386172
153.02,2035,Mobile Home,170,169,1,0.00588235294117647
153.02,2035,Multifamily,145,145,0,0
153.02,2035,Single Family - Detached,1186,1143,43,0.036256323777403
153.02,2040,Mobile Home,170,169,1,0.00588235294117647
153.02,2040,Multifamily,145,143,2,0.0137931034482759
153.02,2040,Single Family - Detached,1200,1161,39,0.0325
153.02,2045,Mobile Home,170,169,1,0.00588235294117647
153.02,2045,Multifamily,145,143,2,0.0137931034482759
153.02,2045,Single Family - Detached,1200,1158,42,0.035
153.02,2050,Mobile Home,170,167,3,0.0176470588235294
153.02,2050,Multifamily,145,143,2,0.0137931034482759
153.02,2050,Single Family - Detached,1200,1156,44,0.0366666666666667
154.03,2012,Mobile Home,0,0,0,
154.03,2012,Multifamily,0,0,0,
154.03,2012,Single Family - Detached,900,880,20,0.0222222222222222
154.03,2020,Mobile Home,0,0,0,
154.03,2020,Multifamily,0,0,0,
154.03,2020,Single Family - Detached,900,879,21,0.0233333333333333
154.03,2025,Mobile Home,0,0,0,
154.03,2025,Multifamily,0,0,0,
154.03,2025,Single Family - Detached,943,929,14,0.0148462354188759
154.03,2030,Mobile Home,0,0,0,
154.03,2030,Multifamily,0,0,0,
154.03,2030,Single Family - Detached,943,929,14,0.0148462354188759
154.03,2035,Mobile Home,0,0,0,
154.03,2035,Multifamily,0,0,0,
154.03,2035,Single Family - Detached,943,930,13,0.0137857900318134
154.03,2040,Mobile Home,0,0,0,
154.03,2040,Multifamily,0,0,0,
154.03,2040,Single Family - Detached,943,928,15,0.0159066808059385
154.03,2045,Mobile Home,0,0,0,
154.03,2045,Multifamily,0,0,0,
154.03,2045,Single Family - Detached,943,928,15,0.0159066808059385
154.03,2050,Mobile Home,0,0,0,
154.03,2050,Multifamily,0,0,0,
154.03,2050,Single Family - Detached,943,928,15,0.0159066808059385
154.04,2012,Mobile Home,199,199,0,0
154.04,2012,Multifamily,1340,1309,31,0.023134328358209
154.04,2012,Single Family - Detached,1223,1162,61,0.0498773507767784
154.04,2020,Mobile Home,199,199,0,0
154.04,2020,Multifamily,1340,1296,44,0.0328358208955224
154.04,2020,Single Family - Detached,1229,1160,69,0.0561432058584215
154.04,2025,Mobile Home,199,199,0,0
154.04,2025,Multifamily,1340,1306,34,0.0253731343283582
154.04,2025,Single Family - Detached,1323,1266,57,0.0430839002267574
154.04,2030,Mobile Home,199,199,0,0
154.04,2030,Multifamily,1340,1306,34,0.0253731343283582
154.04,2030,Single Family - Detached,1336,1274,62,0.0464071856287425
154.04,2035,Mobile Home,199,199,0,0
154.04,2035,Multifamily,1340,1306,34,0.0253731343283582
154.04,2035,Single Family - Detached,1336,1277,59,0.0441616766467066
154.04,2040,Mobile Home,199,199,0,0
154.04,2040,Multifamily,1516,1474,42,0.0277044854881266
154.04,2040,Single Family - Detached,1314,1240,74,0.0563165905631659
154.04,2045,Mobile Home,199,199,0,0
154.04,2045,Multifamily,1516,1472,44,0.029023746701847
154.04,2045,Single Family - Detached,1341,1252,89,0.0663683818046234
154.04,2050,Mobile Home,199,196,3,0.0150753768844221
154.04,2050,Multifamily,1516,1470,46,0.0303430079155673
154.04,2050,Single Family - Detached,1341,1248,93,0.0693512304250559
154.05,2012,Mobile Home,101,101,0,0
154.05,2012,Multifamily,335,335,0,0
154.05,2012,Single Family - Detached,1563,1520,43,0.0275111964171465
154.05,2020,Mobile Home,101,101,0,0
154.05,2020,Multifamily,335,331,4,0.0119402985074627
154.05,2020,Single Family - Detached,1563,1518,45,0.0287907869481766
154.05,2025,Mobile Home,101,101,0,0
154.05,2025,Multifamily,335,335,0,0
154.05,2025,Single Family - Detached,1643,1596,47,0.0286062081558125
154.05,2030,Mobile Home,101,100,1,0.0099009900990099
154.05,2030,Multifamily,335,334,1,0.00298507462686567
154.05,2030,Single Family - Detached,1750,1712,38,0.0217142857142857
154.05,2035,Mobile Home,101,100,1,0.0099009900990099
154.05,2035,Multifamily,335,335,0,0
154.05,2035,Single Family - Detached,1750,1712,38,0.0217142857142857
154.05,2040,Mobile Home,101,100,1,0.0099009900990099
154.05,2040,Multifamily,339,331,8,0.023598820058997
154.05,2040,Single Family - Detached,1773,1732,41,0.0231246474901297
154.05,2045,Mobile Home,101,100,1,0.0099009900990099
154.05,2045,Multifamily,339,331,8,0.023598820058997
154.05,2045,Single Family - Detached,1789,1743,46,0.0257126886528787
154.05,2050,Mobile Home,101,98,3,0.0297029702970297
154.05,2050,Multifamily,339,331,8,0.023598820058997
154.05,2050,Single Family - Detached,1800,1751,49,0.0272222222222222
154.06,2012,Mobile Home,0,0,0,
154.06,2012,Multifamily,0,0,0,
154.06,2012,Single Family - Detached,905,889,16,0.0176795580110497
154.06,2020,Mobile Home,0,0,0,
154.06,2020,Multifamily,0,0,0,
154.06,2020,Single Family - Detached,910,894,16,0.0175824175824176
154.06,2025,Mobile Home,0,0,0,
154.06,2025,Multifamily,0,0,0,
154.06,2025,Single Family - Detached,927,917,10,0.0107874865156419
154.06,2030,Mobile Home,0,0,0,
154.06,2030,Multifamily,0,0,0,
154.06,2030,Single Family - Detached,978,968,10,0.0102249488752556
154.06,2035,Mobile Home,0,0,0,
154.06,2035,Multifamily,0,0,0,
154.06,2035,Single Family - Detached,978,968,10,0.0102249488752556
154.06,2040,Mobile Home,0,0,0,
154.06,2040,Multifamily,0,0,0,
154.06,2040,Single Family - Detached,1022,1011,11,0.0107632093933464
154.06,2045,Mobile Home,0,0,0,
154.06,2045,Multifamily,0,0,0,
154.06,2045,Single Family - Detached,1078,1066,12,0.0111317254174397
154.06,2050,Mobile Home,0,0,0,
154.06,2050,Multifamily,0,0,0,
154.06,2050,Single Family - Detached,1079,1067,12,0.0111214087117702
155.01,2012,Mobile Home,375,375,0,0
155.01,2012,Multifamily,2,0,2,1
155.01,2012,Single Family - Detached,1440,1420,20,0.0138888888888889
155.01,2020,Mobile Home,375,375,0,0
155.01,2020,Multifamily,2,2,0,0
155.01,2020,Single Family - Detached,1719,1688,31,0.0180337405468296
155.01,2025,Mobile Home,375,375,0,0
155.01,2025,Multifamily,2,2,0,0
155.01,2025,Single Family - Detached,1930,1894,36,0.0186528497409326
155.01,2030,Mobile Home,375,371,4,0.0106666666666667
155.01,2030,Multifamily,2,2,0,0
155.01,2030,Single Family - Detached,2364,2317,47,0.0198815566835871
155.01,2035,Mobile Home,375,370,5,0.0133333333333333
155.01,2035,Multifamily,2,2,0,0
155.01,2035,Single Family - Detached,2438,2394,44,0.0180475799835931
155.01,2040,Mobile Home,375,371,4,0.0106666666666667
155.01,2040,Multifamily,2,2,0,0
155.01,2040,Single Family - Detached,2509,2458,51,0.0203268234356317
155.01,2045,Mobile Home,375,367,8,0.0213333333333333
155.01,2045,Multifamily,2,2,0,0
155.01,2045,Single Family - Detached,2567,2493,74,0.028827425009739
155.01,2050,Mobile Home,375,353,22,0.0586666666666667
155.01,2050,Multifamily,2,2,0,0
155.01,2050,Single Family - Detached,2569,2495,74,0.0288049824834566
155.02,2012,Mobile Home,51,51,0,0
155.02,2012,Multifamily,0,0,0,
155.02,2012,Single Family - Detached,962,926,36,0.0374220374220374
155.02,2020,Mobile Home,51,51,0,0
155.02,2020,Multifamily,0,0,0,
155.02,2020,Single Family - Detached,1026,941,85,0.0828460038986355
155.02,2025,Mobile Home,51,51,0,0
155.02,2025,Multifamily,0,0,0,
155.02,2025,Single Family - Detached,1035,954,81,0.0782608695652174
155.02,2030,Mobile Home,51,51,0,0
155.02,2030,Multifamily,0,0,0,
155.02,2030,Single Family - Detached,1053,959,94,0.0892687559354226
155.02,2035,Mobile Home,51,51,0,0
155.02,2035,Multifamily,0,0,0,
155.02,2035,Single Family - Detached,1102,1005,97,0.088021778584392
155.02,2040,Mobile Home,51,51,0,0
155.02,2040,Multifamily,0,0,0,
155.02,2040,Single Family - Detached,1102,997,105,0.0952813067150635
155.02,2045,Mobile Home,51,51,0,0
155.02,2045,Multifamily,0,0,0,
155.02,2045,Single Family - Detached,1102,988,114,0.103448275862069
155.02,2050,Mobile Home,51,51,0,0
155.02,2050,Multifamily,0,0,0,
155.02,2050,Single Family - Detached,1102,980,122,0.11070780399274
156.01,2012,Mobile Home,256,253,3,0.01171875
156.01,2012,Multifamily,777,755,22,0.0283140283140283
156.01,2012,Single Family - Detached,1081,1017,64,0.059204440333025
156.01,2020,Mobile Home,256,254,2,0.0078125
156.01,2020,Multifamily,777,747,30,0.0386100386100386
156.01,2020,Single Family - Detached,1088,1022,66,0.0606617647058824
156.01,2025,Mobile Home,256,255,1,0.00390625
156.01,2025,Multifamily,777,753,24,0.0308880308880309
156.01,2025,Single Family - Detached,1088,1027,61,0.0560661764705882
156.01,2030,Mobile Home,249,245,4,0.0160642570281124
156.01,2030,Multifamily,777,753,24,0.0308880308880309
156.01,2030,Single Family - Detached,1088,1026,62,0.0569852941176471
156.01,2035,Mobile Home,241,241,0,0
156.01,2035,Multifamily,777,755,22,0.0283140283140283
156.01,2035,Single Family - Detached,1088,1025,63,0.0579044117647059
156.01,2040,Mobile Home,225,225,0,0
156.01,2040,Multifamily,822,778,44,0.0535279805352798
156.01,2040,Single Family - Detached,1088,1025,63,0.0579044117647059
156.01,2045,Mobile Home,225,223,2,0.00888888888888889
156.01,2045,Multifamily,822,778,44,0.0535279805352798
156.01,2045,Single Family - Detached,1088,1024,64,0.0588235294117647
156.01,2050,Mobile Home,225,216,9,0.04
156.01,2050,Multifamily,822,778,44,0.0535279805352798
156.01,2050,Single Family - Detached,1088,1024,64,0.0588235294117647
156.02,2012,Mobile Home,0,0,0,
156.02,2012,Multifamily,0,0,0,
156.02,2012,Single Family - Detached,801,789,12,0.0149812734082397
156.02,2020,Mobile Home,0,0,0,
156.02,2020,Multifamily,0,0,0,
156.02,2020,Single Family - Detached,846,826,20,0.0236406619385343
156.02,2025,Mobile Home,0,0,0,
156.02,2025,Multifamily,0,0,0,
156.02,2025,Single Family - Detached,846,834,12,0.0141843971631206
156.02,2030,Mobile Home,0,0,0,
156.02,2030,Multifamily,0,0,0,
156.02,2030,Single Family - Detached,846,833,13,0.0153664302600473
156.02,2035,Mobile Home,0,0,0,
156.02,2035,Multifamily,0,0,0,
156.02,2035,Single Family - Detached,846,833,13,0.0153664302600473
156.02,2040,Mobile Home,0,0,0,
156.02,2040,Multifamily,0,0,0,
156.02,2040,Single Family - Detached,846,829,17,0.0200945626477541
156.02,2045,Mobile Home,0,0,0,
156.02,2045,Multifamily,0,0,0,
156.02,2045,Single Family - Detached,846,824,22,0.0260047281323877
156.02,2050,Mobile Home,0,0,0,
156.02,2050,Multifamily,0,0,0,
156.02,2050,Single Family - Detached,846,822,24,0.0283687943262411
157.01,2012,Mobile Home,495,463,32,0.0646464646464646
157.01,2012,Multifamily,1756,1651,105,0.0597949886104784
157.01,2012,Single Family - Detached,34,34,0,0
157.01,2020,Mobile Home,484,453,31,0.0640495867768595
157.01,2020,Multifamily,1759,1671,88,0.0500284252416146
157.01,2020,Single Family - Detached,46,43,3,0.0652173913043478
157.01,2025,Mobile Home,462,431,31,0.0670995670995671
157.01,2025,Multifamily,1759,1674,85,0.0483229107447413
157.01,2025,Single Family - Detached,46,46,0,0
157.01,2030,Mobile Home,458,427,31,0.0676855895196507
157.01,2030,Multifamily,1759,1673,86,0.0488914155770324
157.01,2030,Single Family - Detached,46,43,3,0.0652173913043478
157.01,2035,Mobile Home,458,429,29,0.0633187772925764
157.01,2035,Multifamily,1759,1674,85,0.0483229107447413
157.01,2035,Single Family - Detached,46,43,3,0.0652173913043478
157.01,2040,Mobile Home,458,434,24,0.0524017467248908
157.01,2040,Multifamily,1825,1751,74,0.0405479452054795
157.01,2040,Single Family - Detached,33,27,6,0.181818181818182
157.01,2045,Mobile Home,458,432,26,0.0567685589519651
157.01,2045,Multifamily,1825,1750,75,0.0410958904109589
157.01,2045,Single Family - Detached,33,23,10,0.303030303030303
157.01,2050,Mobile Home,458,424,34,0.074235807860262
157.01,2050,Multifamily,1825,1750,75,0.0410958904109589
157.01,2050,Single Family - Detached,33,20,13,0.393939393939394
157.03,2012,Mobile Home,312,302,10,0.032051282051282
157.03,2012,Multifamily,2026,1964,62,0.0306021717670286
157.03,2012,Single Family - Detached,60,60,0,0
157.03,2020,Mobile Home,312,302,10,0.032051282051282
157.03,2020,Multifamily,2021,1968,53,0.0262246412666997
157.03,2020,Single Family - Detached,52,49,3,0.0576923076923077
157.03,2025,Mobile Home,312,302,10,0.032051282051282
157.03,2025,Multifamily,2023,1977,46,0.0227385071675729
157.03,2025,Single Family - Detached,52,52,0,0
157.03,2030,Mobile Home,312,302,10,0.032051282051282
157.03,2030,Multifamily,2028,1984,44,0.0216962524654832
157.03,2030,Single Family - Detached,52,49,3,0.0576923076923077
157.03,2035,Mobile Home,312,303,9,0.0288461538461538
157.03,2035,Multifamily,2028,1984,44,0.0216962524654832
157.03,2035,Single Family - Detached,52,51,1,0.0192307692307692
157.03,2040,Mobile Home,312,305,7,0.0224358974358974
157.03,2040,Multifamily,2089,2024,65,0.0311153662039253
157.03,2040,Single Family - Detached,51,47,4,0.0784313725490196
157.03,2045,Mobile Home,312,305,7,0.0224358974358974
157.03,2045,Multifamily,2089,2024,65,0.0311153662039253
157.03,2045,Single Family - Detached,51,45,6,0.117647058823529
157.03,2050,Mobile Home,312,303,9,0.0288461538461538
157.03,2050,Multifamily,2089,2024,65,0.0311153662039253
157.03,2050,Single Family - Detached,51,45,6,0.117647058823529
157.04,2012,Mobile Home,261,212,49,0.187739463601533
157.04,2012,Multifamily,726,689,37,0.0509641873278237
157.04,2012,Single Family - Detached,493,472,21,0.0425963488843813
157.04,2020,Mobile Home,261,212,49,0.187739463601533
157.04,2020,Multifamily,726,680,46,0.0633608815426997
157.04,2020,Single Family - Detached,494,472,22,0.0445344129554656
157.04,2025,Mobile Home,261,212,49,0.187739463601533
157.04,2025,Multifamily,726,688,38,0.0523415977961433
157.04,2025,Single Family - Detached,494,476,18,0.0364372469635627
157.04,2030,Mobile Home,261,209,52,0.199233716475096
157.04,2030,Multifamily,726,687,39,0.0537190082644628
157.04,2030,Single Family - Detached,494,475,19,0.0384615384615385
157.04,2035,Mobile Home,261,213,48,0.183908045977011
157.04,2035,Multifamily,726,688,38,0.0523415977961433
157.04,2035,Single Family - Detached,494,476,18,0.0364372469635627
157.04,2040,Mobile Home,259,212,47,0.181467181467181
157.04,2040,Multifamily,775,750,25,0.032258064516129
157.04,2040,Single Family - Detached,490,475,15,0.0306122448979592
157.04,2045,Mobile Home,259,209,50,0.193050193050193
157.04,2045,Multifamily,775,750,25,0.032258064516129
157.04,2045,Single Family - Detached,490,474,16,0.0326530612244898
157.04,2050,Mobile Home,259,202,57,0.22007722007722
157.04,2050,Multifamily,775,749,26,0.0335483870967742
157.04,2050,Single Family - Detached,490,474,16,0.0326530612244898
158.01,2012,Mobile Home,0,0,0,
158.01,2012,Multifamily,1301,1252,49,0.037663335895465
158.01,2012,Single Family - Detached,147,150,-3,-0.0204081632653061
158.01,2020,Mobile Home,0,0,0,
158.01,2020,Multifamily,1309,1263,46,0.0351413292589763
158.01,2020,Single Family - Detached,213,214,-1,-0.00469483568075117
158.01,2025,Mobile Home,0,0,0,
158.01,2025,Multifamily,1309,1269,40,0.0305576776165011
158.01,2025,Single Family - Detached,213,216,-3,-0.0140845070422535
158.01,2030,Mobile Home,0,0,0,
158.01,2030,Multifamily,1309,1267,42,0.0320855614973262
158.01,2030,Single Family - Detached,213,215,-2,-0.00938967136150235
158.01,2035,Mobile Home,0,0,0,
158.01,2035,Multifamily,1309,1266,43,0.0328495034377387
158.01,2035,Single Family - Detached,213,215,-2,-0.00938967136150235
158.01,2040,Mobile Home,0,0,0,
158.01,2040,Multifamily,1309,1260,49,0.0374331550802139
158.01,2040,Single Family - Detached,213,212,1,0.00469483568075117
158.01,2045,Mobile Home,0,0,0,
158.01,2045,Multifamily,1309,1256,53,0.040488922841864
158.01,2045,Single Family - Detached,213,209,4,0.0187793427230047
158.01,2050,Mobile Home,0,0,0,
158.01,2050,Multifamily,1309,1252,57,0.0435446906035141
158.01,2050,Single Family - Detached,213,207,6,0.028169014084507
158.02,2012,Mobile Home,0,0,0,
158.02,2012,Multifamily,1064,943,121,0.113721804511278
158.02,2012,Single Family - Detached,480,465,15,0.03125
158.02,2020,Mobile Home,0,0,0,
158.02,2020,Multifamily,1064,938,126,0.118421052631579
158.02,2020,Single Family - Detached,480,462,18,0.0375
158.02,2025,Mobile Home,0,0,0,
158.02,2025,Multifamily,1064,953,111,0.104323308270677
158.02,2025,Single Family - Detached,480,463,17,0.0354166666666667
158.02,2030,Mobile Home,0,0,0,
158.02,2030,Multifamily,1064,944,120,0.112781954887218
158.02,2030,Single Family - Detached,480,462,18,0.0375
158.02,2035,Mobile Home,0,0,0,
158.02,2035,Multifamily,1064,947,117,0.109962406015038
158.02,2035,Single Family - Detached,480,462,18,0.0375
158.02,2040,Mobile Home,0,0,0,
158.02,2040,Multifamily,1064,928,136,0.12781954887218
158.02,2040,Single Family - Detached,480,461,19,0.0395833333333333
158.02,2045,Mobile Home,0,0,0,
158.02,2045,Multifamily,1064,914,150,0.140977443609023
158.02,2045,Single Family - Detached,480,460,20,0.0416666666666667
158.02,2050,Mobile Home,0,0,0,
158.02,2050,Multifamily,1064,902,162,0.152255639097744
158.02,2050,Single Family - Detached,480,459,21,0.04375
159.01,2012,Mobile Home,88,88,0,0
159.01,2012,Multifamily,805,802,3,0.00372670807453416
159.01,2012,Single Family - Detached,136,137,-1,-0.00735294117647059
159.01,2020,Mobile Home,88,88,0,0
159.01,2020,Multifamily,805,800,5,0.0062111801242236
159.01,2020,Single Family - Detached,136,135,1,0.00735294117647059
159.01,2025,Mobile Home,88,88,0,0
159.01,2025,Multifamily,810,808,2,0.00246913580246914
159.01,2025,Single Family - Detached,136,135,1,0.00735294117647059
159.01,2030,Mobile Home,88,87,1,0.0113636363636364
159.01,2030,Multifamily,822,817,5,0.00608272506082725
159.01,2030,Single Family - Detached,136,135,1,0.00735294117647059
159.01,2035,Mobile Home,88,87,1,0.0113636363636364
159.01,2035,Multifamily,863,858,5,0.00579374275782155
159.01,2035,Single Family - Detached,133,133,0,0
159.01,2040,Mobile Home,88,88,0,0
159.01,2040,Multifamily,935,922,13,0.013903743315508
159.01,2040,Single Family - Detached,129,127,2,0.0155038759689922
159.01,2045,Mobile Home,88,87,1,0.0113636363636364
159.01,2045,Multifamily,1039,1024,15,0.014436958614052
159.01,2045,Single Family - Detached,124,120,4,0.032258064516129
159.01,2050,Mobile Home,88,84,4,0.0454545454545455
159.01,2050,Multifamily,1173,1157,16,0.0136402387041773
159.01,2050,Single Family - Detached,108,103,5,0.0462962962962963
159.02,2012,Mobile Home,0,0,0,
159.02,2012,Multifamily,1066,1033,33,0.0309568480300188
159.02,2012,Single Family - Detached,772,755,17,0.022020725388601
159.02,2020,Mobile Home,0,0,0,
159.02,2020,Multifamily,1066,1033,33,0.0309568480300188
159.02,2020,Single Family - Detached,776,759,17,0.0219072164948454
159.02,2025,Mobile Home,0,0,0,
159.02,2025,Multifamily,1083,1051,32,0.0295475530932595
159.02,2025,Single Family - Detached,776,759,17,0.0219072164948454
159.02,2030,Mobile Home,0,0,0,
159.02,2030,Multifamily,1664,1617,47,0.0282451923076923
159.02,2030,Single Family - Detached,733,718,15,0.0204638472032742
159.02,2035,Mobile Home,0,0,0,
159.02,2035,Multifamily,1669,1624,45,0.0269622528460156
159.02,2035,Single Family - Detached,733,718,15,0.0204638472032742
159.02,2040,Mobile Home,0,0,0,
159.02,2040,Multifamily,1675,1630,45,0.026865671641791
159.02,2040,Single Family - Detached,733,718,15,0.0204638472032742
159.02,2045,Mobile Home,0,0,0,
159.02,2045,Multifamily,1680,1635,45,0.0267857142857143
159.02,2045,Single Family - Detached,733,717,16,0.0218281036834925
159.02,2050,Mobile Home,0,0,0,
159.02,2050,Multifamily,1684,1639,45,0.0267220902612827
159.02,2050,Single Family - Detached,733,717,16,0.0218281036834925
16,2012,Mobile Home,0,0,0,
16,2012,Multifamily,1672,1596,76,0.0454545454545455
16,2012,Single Family - Detached,722,671,51,0.0706371191135734
16,2020,Mobile Home,0,0,0,
16,2020,Multifamily,2450,2383,67,0.0273469387755102
16,2020,Single Family - Detached,510,459,51,0.1
16,2025,Mobile Home,0,0,0,
16,2025,Multifamily,2464,2397,67,0.0271915584415584
16,2025,Single Family - Detached,494,458,36,0.0728744939271255
16,2030,Mobile Home,0,0,0,
16,2030,Multifamily,2748,2681,67,0.0243813682678312
16,2030,Single Family - Detached,376,346,30,0.0797872340425532
16,2035,Mobile Home,0,0,0,
16,2035,Multifamily,2806,2739,67,0.0238774055595153
16,2035,Single Family - Detached,353,327,26,0.0736543909348442
16,2040,Mobile Home,0,0,0,
16,2040,Multifamily,2842,2761,81,0.0285010555946517
16,2040,Single Family - Detached,349,317,32,0.0916905444126074
16,2045,Mobile Home,0,0,0,
16,2045,Multifamily,2883,2782,101,0.0350329517863337
16,2045,Single Family - Detached,332,290,42,0.126506024096386
16,2050,Mobile Home,0,0,0,
16,2050,Multifamily,3199,3091,108,0.0337605501719287
16,2050,Single Family - Detached,245,202,43,0.175510204081633
160,2012,Mobile Home,0,0,0,
160,2012,Multifamily,246,240,6,0.024390243902439
160,2012,Single Family - Detached,693,663,30,0.0432900432900433
160,2020,Mobile Home,0,0,0,
160,2020,Multifamily,246,238,8,0.032520325203252
160,2020,Single Family - Detached,694,660,34,0.0489913544668588
160,2025,Mobile Home,0,0,0,
160,2025,Multifamily,367,360,7,0.0190735694822888
160,2025,Single Family - Detached,694,661,33,0.0475504322766571
160,2030,Mobile Home,0,0,0,
160,2030,Multifamily,542,530,12,0.022140221402214
160,2030,Single Family - Detached,694,660,34,0.0489913544668588
160,2035,Mobile Home,0,0,0,
160,2035,Multifamily,1138,1112,26,0.0228471001757469
160,2035,Single Family - Detached,678,652,26,0.0383480825958702
160,2040,Mobile Home,0,0,0,
160,2040,Multifamily,1806,1765,41,0.0227021040974529
160,2040,Single Family - Detached,591,564,27,0.0456852791878173
160,2045,Mobile Home,0,0,0,
160,2045,Multifamily,2347,2281,66,0.0281210055389859
160,2045,Single Family - Detached,540,512,28,0.0518518518518519
160,2050,Mobile Home,0,0,0,
160,2050,Multifamily,2728,2646,82,0.030058651026393
160,2050,Single Family - Detached,504,479,25,0.0496031746031746
161,2012,Mobile Home,0,0,0,
161,2012,Multifamily,645,633,12,0.0186046511627907
161,2012,Single Family - Detached,1668,1614,54,0.0323741007194245
161,2020,Mobile Home,0,0,0,
161,2020,Multifamily,645,636,9,0.013953488372093
161,2020,Single Family - Detached,1668,1612,56,0.0335731414868106
161,2025,Mobile Home,0,0,0,
161,2025,Multifamily,645,637,8,0.0124031007751938
161,2025,Single Family - Detached,1679,1634,45,0.026801667659321
161,2030,Mobile Home,0,0,0,
161,2030,Multifamily,647,639,8,0.0123647604327666
161,2030,Single Family - Detached,1675,1629,46,0.0274626865671642
161,2035,Mobile Home,0,0,0,
161,2035,Multifamily,647,640,7,0.0108191653786708
161,2035,Single Family - Detached,1673,1627,46,0.027495517035266
161,2040,Mobile Home,0,0,0,
161,2040,Multifamily,647,637,10,0.0154559505409583
161,2040,Single Family - Detached,1673,1623,50,0.0298864315600717
161,2045,Mobile Home,0,0,0,
161,2045,Multifamily,647,637,10,0.0154559505409583
161,2045,Single Family - Detached,1673,1621,52,0.0310818888224746
161,2050,Mobile Home,0,0,0,
161,2050,Multifamily,647,637,10,0.0154559505409583
161,2050,Single Family - Detached,1673,1621,52,0.0310818888224746
162.01,2012,Mobile Home,0,0,0,
162.01,2012,Multifamily,222,220,2,0.00900900900900901
162.01,2012,Single Family - Detached,2009,1964,45,0.0223992035838726
162.01,2020,Mobile Home,0,0,0,
162.01,2020,Multifamily,222,221,1,0.0045045045045045
162.01,2020,Single Family - Detached,2009,1965,44,0.021901443504231
162.01,2025,Mobile Home,0,0,0,
162.01,2025,Multifamily,222,222,0,0
162.01,2025,Single Family - Detached,2034,2000,34,0.0167158308751229
162.01,2030,Mobile Home,0,0,0,
162.01,2030,Multifamily,223,223,0,0
162.01,2030,Single Family - Detached,2034,1999,35,0.0172074729596853
162.01,2035,Mobile Home,0,0,0,
162.01,2035,Multifamily,223,223,0,0
162.01,2035,Single Family - Detached,2077,2049,28,0.013480982185845
162.01,2040,Mobile Home,0,0,0,
162.01,2040,Multifamily,224,223,1,0.00446428571428571
162.01,2040,Single Family - Detached,2077,2044,33,0.0158883004333173
162.01,2045,Mobile Home,0,0,0,
162.01,2045,Multifamily,224,222,2,0.00892857142857143
162.01,2045,Single Family - Detached,2077,2043,34,0.0163697640828117
162.01,2050,Mobile Home,0,0,0,
162.01,2050,Multifamily,224,221,3,0.0133928571428571
162.01,2050,Single Family - Detached,2077,2043,34,0.0163697640828117
162.02,2012,Mobile Home,0,0,0,
162.02,2012,Multifamily,1395,1306,89,0.0637992831541219
162.02,2012,Single Family - Detached,137,143,-6,-0.0437956204379562
162.02,2020,Mobile Home,0,0,0,
162.02,2020,Multifamily,1395,1312,83,0.0594982078853047
162.02,2020,Single Family - Detached,116,115,1,0.00862068965517241
162.02,2025,Mobile Home,0,0,0,
162.02,2025,Multifamily,1607,1524,83,0.0516490354698195
162.02,2025,Single Family - Detached,116,117,-1,-0.00862068965517241
162.02,2030,Mobile Home,0,0,0,
162.02,2030,Multifamily,1819,1725,94,0.051676745464541
162.02,2030,Single Family - Detached,116,116,0,0
162.02,2035,Mobile Home,0,0,0,
162.02,2035,Multifamily,1926,1832,94,0.0488058151609553
162.02,2035,Single Family - Detached,116,117,-1,-0.00862068965517241
162.02,2040,Mobile Home,0,0,0,
162.02,2040,Multifamily,2188,2073,115,0.0525594149908592
162.02,2040,Single Family - Detached,111,110,1,0.00900900900900901
162.02,2045,Mobile Home,0,0,0,
162.02,2045,Multifamily,2230,2107,123,0.0551569506726457
162.02,2045,Single Family - Detached,109,107,2,0.018348623853211
162.02,2050,Mobile Home,0,0,0,
162.02,2050,Multifamily,2266,2138,128,0.0564872021182701
162.02,2050,Single Family - Detached,106,104,2,0.0188679245283019
163.01,2012,Mobile Home,0,0,0,
163.01,2012,Multifamily,1325,1278,47,0.0354716981132076
163.01,2012,Single Family - Detached,535,481,54,0.100934579439252
163.01,2020,Mobile Home,0,0,0,
163.01,2020,Multifamily,1356,1327,29,0.0213864306784661
163.01,2020,Single Family - Detached,560,514,46,0.0821428571428571
163.01,2025,Mobile Home,0,0,0,
163.01,2025,Multifamily,1422,1395,27,0.0189873417721519
163.01,2025,Single Family - Detached,560,521,39,0.0696428571428571
163.01,2030,Mobile Home,0,0,0,
163.01,2030,Multifamily,1457,1430,27,0.0185312285518188
163.01,2030,Single Family - Detached,560,521,39,0.0696428571428571
163.01,2035,Mobile Home,0,0,0,
163.01,2035,Multifamily,1457,1430,27,0.0185312285518188
163.01,2035,Single Family - Detached,560,523,37,0.0660714285714286
163.01,2040,Mobile Home,0,0,0,
163.01,2040,Multifamily,1660,1631,29,0.0174698795180723
163.01,2040,Single Family - Detached,552,513,39,0.0706521739130435
163.01,2045,Mobile Home,0,0,0,
163.01,2045,Multifamily,1705,1674,31,0.0181818181818182
163.01,2045,Single Family - Detached,547,505,42,0.076782449725777
163.01,2050,Mobile Home,0,0,0,
163.01,2050,Multifamily,1705,1674,31,0.0181818181818182
163.01,2050,Single Family - Detached,547,503,44,0.0804387568555759
163.02,2012,Mobile Home,73,73,0,0
163.02,2012,Multifamily,1035,984,51,0.0492753623188406
163.02,2012,Single Family - Detached,732,713,19,0.0259562841530055
163.02,2020,Mobile Home,73,73,0,0
163.02,2020,Multifamily,1035,980,55,0.0531400966183575
163.02,2020,Single Family - Detached,750,717,33,0.044
163.02,2025,Mobile Home,73,73,0,0
163.02,2025,Multifamily,1035,986,49,0.0473429951690821
163.02,2025,Single Family - Detached,750,723,27,0.036
163.02,2030,Mobile Home,73,73,0,0
163.02,2030,Multifamily,1035,985,50,0.0483091787439614
163.02,2030,Single Family - Detached,750,720,30,0.04
163.02,2035,Mobile Home,73,65,8,0.10958904109589
163.02,2035,Multifamily,1035,986,49,0.0473429951690821
163.02,2035,Single Family - Detached,750,725,25,0.0333333333333333
163.02,2040,Mobile Home,73,65,8,0.10958904109589
163.02,2040,Multifamily,1035,980,55,0.0531400966183575
163.02,2040,Single Family - Detached,750,721,29,0.0386666666666667
163.02,2045,Mobile Home,73,66,7,0.0958904109589041
163.02,2045,Multifamily,1035,976,59,0.0570048309178744
163.02,2045,Single Family - Detached,750,719,31,0.0413333333333333
163.02,2050,Mobile Home,73,67,6,0.0821917808219178
163.02,2050,Multifamily,1035,976,59,0.0570048309178744
163.02,2050,Single Family - Detached,750,718,32,0.0426666666666667
164.01,2012,Mobile Home,182,182,0,0
164.01,2012,Multifamily,216,217,-1,-0.00462962962962963
164.01,2012,Single Family - Detached,1281,1242,39,0.0304449648711944
164.01,2020,Mobile Home,182,180,2,0.010989010989011
164.01,2020,Multifamily,216,209,7,0.0324074074074074
164.01,2020,Single Family - Detached,1303,1250,53,0.0406753645433615
164.01,2025,Mobile Home,167,165,2,0.0119760479041916
164.01,2025,Multifamily,216,209,7,0.0324074074074074
164.01,2025,Single Family - Detached,1324,1283,41,0.0309667673716012
164.01,2030,Mobile Home,167,165,2,0.0119760479041916
164.01,2030,Multifamily,216,207,9,0.0416666666666667
164.01,2030,Single Family - Detached,1386,1326,60,0.0432900432900433
164.01,2035,Mobile Home,167,166,1,0.00598802395209581
164.01,2035,Multifamily,216,207,9,0.0416666666666667
164.01,2035,Single Family - Detached,1463,1411,52,0.0355434039644566
164.01,2040,Mobile Home,167,167,0,0
164.01,2040,Multifamily,216,202,14,0.0648148148148148
164.01,2040,Single Family - Detached,1537,1475,62,0.0403383214053351
164.01,2045,Mobile Home,167,167,0,0
164.01,2045,Multifamily,216,199,17,0.0787037037037037
164.01,2045,Single Family - Detached,1582,1522,60,0.0379266750948167
164.01,2050,Mobile Home,167,165,2,0.0119760479041916
164.01,2050,Multifamily,216,197,19,0.087962962962963
164.01,2050,Single Family - Detached,1616,1551,65,0.0402227722772277
164.02,2012,Mobile Home,158,150,8,0.0506329113924051
164.02,2012,Multifamily,1152,1081,71,0.0616319444444444
164.02,2012,Single Family - Detached,1409,1383,26,0.0184528034066714
164.02,2020,Mobile Home,158,150,8,0.0506329113924051
164.02,2020,Multifamily,1152,1069,83,0.0720486111111111
164.02,2020,Single Family - Detached,1441,1371,70,0.0485773768216516
164.02,2025,Mobile Home,132,131,1,0.00757575757575758
164.02,2025,Multifamily,1148,1074,74,0.0644599303135888
164.02,2025,Single Family - Detached,1453,1397,56,0.0385409497591191
164.02,2030,Mobile Home,45,45,0,0
164.02,2030,Multifamily,1148,1072,76,0.0662020905923345
164.02,2030,Single Family - Detached,1459,1408,51,0.0349554489376285
164.02,2035,Mobile Home,0,0,0,
164.02,2035,Multifamily,1148,1075,73,0.063588850174216
164.02,2035,Single Family - Detached,1460,1413,47,0.0321917808219178
164.02,2040,Mobile Home,0,0,0,
164.02,2040,Multifamily,1151,1070,81,0.0703735881841877
164.02,2040,Single Family - Detached,1460,1408,52,0.0356164383561644
164.02,2045,Mobile Home,0,0,0,
164.02,2045,Multifamily,1152,1067,85,0.0737847222222222
164.02,2045,Single Family - Detached,1460,1400,60,0.0410958904109589
164.02,2050,Mobile Home,0,0,0,
164.02,2050,Multifamily,1152,1065,87,0.0755208333333333
164.02,2050,Single Family - Detached,1460,1396,64,0.0438356164383562
165.02,2012,Mobile Home,0,0,0,
165.02,2012,Multifamily,788,869,-81,-0.102791878172589
165.02,2012,Single Family - Detached,1582,1474,108,0.06826801517067
165.02,2020,Mobile Home,0,0,0,
165.02,2020,Multifamily,746,770,-24,-0.032171581769437
165.02,2020,Single Family - Detached,1551,1440,111,0.0715667311411992
165.02,2025,Mobile Home,0,0,0,
165.02,2025,Multifamily,742,767,-25,-0.0336927223719677
165.02,2025,Single Family - Detached,1664,1576,88,0.0528846153846154
165.02,2030,Mobile Home,0,0,0,
165.02,2030,Multifamily,742,762,-20,-0.0269541778975741
165.02,2030,Single Family - Detached,1737,1613,124,0.0713874496257916
165.02,2035,Mobile Home,0,0,0,
165.02,2035,Multifamily,742,763,-21,-0.0283018867924528
165.02,2035,Single Family - Detached,1765,1643,122,0.0691218130311615
165.02,2040,Mobile Home,0,0,0,
165.02,2040,Multifamily,752,768,-16,-0.0212765957446809
165.02,2040,Single Family - Detached,1791,1654,137,0.0764935790061418
165.02,2045,Mobile Home,0,0,0,
165.02,2045,Multifamily,752,766,-14,-0.0186170212765957
165.02,2045,Single Family - Detached,1795,1630,165,0.0919220055710306
165.02,2050,Mobile Home,0,0,0,
165.02,2050,Multifamily,752,765,-13,-0.0172872340425532
165.02,2050,Single Family - Detached,1795,1623,172,0.0958217270194986
165.03,2012,Mobile Home,218,198,20,0.0917431192660551
165.03,2012,Multifamily,500,504,-4,-0.008
165.03,2012,Single Family - Detached,406,337,69,0.169950738916256
165.03,2020,Mobile Home,218,194,24,0.110091743119266
165.03,2020,Multifamily,500,499,1,0.002
165.03,2020,Single Family - Detached,406,334,72,0.177339901477833
165.03,2025,Mobile Home,218,193,25,0.114678899082569
165.03,2025,Multifamily,500,498,2,0.004
165.03,2025,Single Family - Detached,533,452,81,0.151969981238274
165.03,2030,Mobile Home,218,191,27,0.123853211009174
165.03,2030,Multifamily,500,497,3,0.006
165.03,2030,Single Family - Detached,674,632,42,0.0623145400593472
165.03,2035,Mobile Home,218,193,25,0.114678899082569
165.03,2035,Multifamily,500,497,3,0.006
165.03,2035,Single Family - Detached,674,632,42,0.0623145400593472
165.03,2040,Mobile Home,218,197,21,0.0963302752293578
165.03,2040,Multifamily,500,497,3,0.006
165.03,2040,Single Family - Detached,674,632,42,0.0623145400593472
165.03,2045,Mobile Home,218,195,23,0.105504587155963
165.03,2045,Multifamily,502,499,3,0.00597609561752988
165.03,2045,Single Family - Detached,674,628,46,0.0682492581602374
165.03,2050,Mobile Home,218,189,29,0.13302752293578
165.03,2050,Multifamily,502,499,3,0.00597609561752988
165.03,2050,Single Family - Detached,674,628,46,0.0682492581602374
165.04,2012,Mobile Home,512,490,22,0.04296875
165.04,2012,Multifamily,1712,1616,96,0.0560747663551402
165.04,2012,Single Family - Detached,306,292,14,0.0457516339869281
165.04,2020,Mobile Home,501,487,14,0.0279441117764471
165.04,2020,Multifamily,1765,1740,25,0.0141643059490085
165.04,2020,Single Family - Detached,384,366,18,0.046875
165.04,2025,Mobile Home,497,484,13,0.0261569416498994
165.04,2025,Multifamily,1776,1757,19,0.0106981981981982
165.04,2025,Single Family - Detached,399,390,9,0.0225563909774436
165.04,2030,Mobile Home,464,450,14,0.0301724137931034
165.04,2030,Multifamily,1860,1848,12,0.00645161290322581
165.04,2030,Single Family - Detached,399,379,20,0.050125313283208
165.04,2035,Mobile Home,463,451,12,0.0259179265658747
165.04,2035,Multifamily,1863,1851,12,0.00644122383252818
165.04,2035,Single Family - Detached,399,380,19,0.0476190476190476
165.04,2040,Mobile Home,310,302,8,0.0258064516129032
165.04,2040,Multifamily,2205,2189,16,0.0072562358276644
165.04,2040,Single Family - Detached,399,376,23,0.0576441102756892
165.04,2045,Mobile Home,274,265,9,0.0328467153284672
165.04,2045,Multifamily,2268,2251,17,0.00749559082892416
165.04,2045,Single Family - Detached,399,370,29,0.0726817042606516
165.04,2050,Mobile Home,274,260,14,0.0510948905109489
165.04,2050,Multifamily,2268,2251,17,0.00749559082892416
165.04,2050,Single Family - Detached,399,368,31,0.0776942355889724
166.05,2012,Mobile Home,1075,1058,17,0.0158139534883721
166.05,2012,Multifamily,901,879,22,0.0244173140954495
166.05,2012,Single Family - Detached,1322,1248,74,0.0559757942511346
166.05,2020,Mobile Home,1075,1059,16,0.0148837209302326
166.05,2020,Multifamily,949,926,23,0.0242360379346681
166.05,2020,Single Family - Detached,1422,1350,72,0.0506329113924051
166.05,2025,Mobile Home,1075,1059,16,0.0148837209302326
166.05,2025,Multifamily,982,964,18,0.0183299389002037
166.05,2025,Single Family - Detached,1422,1362,60,0.0421940928270042
166.05,2030,Mobile Home,1075,1055,20,0.0186046511627907
166.05,2030,Multifamily,1024,1006,18,0.017578125
166.05,2030,Single Family - Detached,1416,1356,60,0.0423728813559322
166.05,2035,Mobile Home,1075,1055,20,0.0186046511627907
166.05,2035,Multifamily,1024,1006,18,0.017578125
166.05,2035,Single Family - Detached,1421,1364,57,0.0401125967628431
166.05,2040,Mobile Home,1075,1056,19,0.0176744186046512
166.05,2040,Multifamily,1164,1130,34,0.0292096219931271
166.05,2040,Single Family - Detached,1487,1424,63,0.0423671822461332
166.05,2045,Mobile Home,1075,1053,22,0.0204651162790698
166.05,2045,Multifamily,1173,1137,36,0.030690537084399
166.05,2045,Single Family - Detached,1495,1427,68,0.0454849498327759
166.05,2050,Mobile Home,1075,1037,38,0.0353488372093023
166.05,2050,Multifamily,1173,1136,37,0.0315430520034101
166.05,2050,Single Family - Detached,1505,1436,69,0.0458471760797342
166.06,2012,Mobile Home,0,0,0,
166.06,2012,Multifamily,335,330,5,0.0149253731343284
166.06,2012,Single Family - Detached,924,909,15,0.0162337662337662
166.06,2020,Mobile Home,0,0,0,
166.06,2020,Multifamily,335,332,3,0.00895522388059702
166.06,2020,Single Family - Detached,925,897,28,0.0302702702702703
166.06,2025,Mobile Home,0,0,0,
166.06,2025,Multifamily,335,333,2,0.00597014925373134
166.06,2025,Single Family - Detached,925,908,17,0.0183783783783784
166.06,2030,Mobile Home,0,0,0,
166.06,2030,Multifamily,335,331,4,0.0119402985074627
166.06,2030,Single Family - Detached,925,908,17,0.0183783783783784
166.06,2035,Mobile Home,0,0,0,
166.06,2035,Multifamily,335,331,4,0.0119402985074627
166.06,2035,Single Family - Detached,925,911,14,0.0151351351351351
166.06,2040,Mobile Home,0,0,0,
166.06,2040,Multifamily,335,328,7,0.0208955223880597
166.06,2040,Single Family - Detached,926,908,18,0.019438444924406
166.06,2045,Mobile Home,0,0,0,
166.06,2045,Multifamily,335,326,9,0.026865671641791
166.06,2045,Single Family - Detached,926,903,23,0.0248380129589633
166.06,2050,Mobile Home,0,0,0,
166.06,2050,Multifamily,335,325,10,0.0298507462686567
166.06,2050,Single Family - Detached,926,902,24,0.0259179265658747
166.07,2012,Mobile Home,574,574,0,0
166.07,2012,Multifamily,382,378,4,0.0104712041884817
166.07,2012,Single Family - Detached,1430,1401,29,0.0202797202797203
166.07,2020,Mobile Home,574,574,0,0
166.07,2020,Multifamily,392,392,0,0
166.07,2020,Single Family - Detached,1494,1454,40,0.0267737617135207
166.07,2025,Mobile Home,574,574,0,0
166.07,2025,Multifamily,392,392,0,0
166.07,2025,Single Family - Detached,1494,1456,38,0.0254350736278447
166.07,2030,Mobile Home,574,572,2,0.00348432055749129
166.07,2030,Multifamily,394,394,0,0
166.07,2030,Single Family - Detached,1494,1456,38,0.0254350736278447
166.07,2035,Mobile Home,574,572,2,0.00348432055749129
166.07,2035,Multifamily,394,394,0,0
166.07,2035,Single Family - Detached,1494,1456,38,0.0254350736278447
166.07,2040,Mobile Home,574,573,1,0.00174216027874564
166.07,2040,Multifamily,444,443,1,0.00225225225225225
166.07,2040,Single Family - Detached,1494,1455,39,0.0261044176706827
166.07,2045,Mobile Home,574,571,3,0.00522648083623693
166.07,2045,Multifamily,742,741,1,0.00134770889487871
166.07,2045,Single Family - Detached,1521,1500,21,0.0138067061143984
166.07,2050,Mobile Home,574,564,10,0.0174216027874564
166.07,2050,Multifamily,742,741,1,0.00134770889487871
166.07,2050,Single Family - Detached,1523,1502,21,0.0137885751805647
166.08,2012,Mobile Home,0,0,0,
166.08,2012,Multifamily,0,0,0,
166.08,2012,Single Family - Detached,818,817,1,0.00122249388753056
166.08,2020,Mobile Home,0,0,0,
166.08,2020,Multifamily,0,0,0,
166.08,2020,Single Family - Detached,916,912,4,0.00436681222707424
166.08,2025,Mobile Home,0,0,0,
166.08,2025,Multifamily,0,0,0,
166.08,2025,Single Family - Detached,949,946,3,0.00316122233930453
166.08,2030,Mobile Home,0,0,0,
166.08,2030,Multifamily,0,0,0,
166.08,2030,Single Family - Detached,1026,1022,4,0.00389863547758285
166.08,2035,Mobile Home,0,0,0,
166.08,2035,Multifamily,0,0,0,
166.08,2035,Single Family - Detached,1043,1039,4,0.00383509108341323
166.08,2040,Mobile Home,0,0,0,
166.08,2040,Multifamily,0,0,0,
166.08,2040,Single Family - Detached,1056,1049,7,0.00662878787878788
166.08,2045,Mobile Home,0,0,0,
166.08,2045,Multifamily,0,0,0,
166.08,2045,Single Family - Detached,1060,1051,9,0.00849056603773585
166.08,2050,Mobile Home,0,0,0,
166.08,2050,Multifamily,0,0,0,
166.08,2050,Single Family - Detached,1060,1051,9,0.00849056603773585
166.09,2012,Mobile Home,0,0,0,
166.09,2012,Multifamily,260,260,0,0
166.09,2012,Single Family - Detached,1519,1508,11,0.00724160631994733
166.09,2020,Mobile Home,0,0,0,
166.09,2020,Multifamily,260,260,0,0
166.09,2020,Single Family - Detached,1591,1576,15,0.00942803268384664
166.09,2025,Mobile Home,0,0,0,
166.09,2025,Multifamily,260,260,0,0
166.09,2025,Single Family - Detached,1803,1793,10,0.00554631170271769
166.09,2030,Mobile Home,0,0,0,
166.09,2030,Multifamily,261,261,0,0
166.09,2030,Single Family - Detached,1875,1864,11,0.00586666666666667
166.09,2035,Mobile Home,0,0,0,
166.09,2035,Multifamily,261,261,0,0
166.09,2035,Single Family - Detached,1896,1887,9,0.00474683544303797
166.09,2040,Mobile Home,0,0,0,
166.09,2040,Multifamily,262,262,0,0
166.09,2040,Single Family - Detached,1899,1887,12,0.00631911532385466
166.09,2045,Mobile Home,0,0,0,
166.09,2045,Multifamily,262,262,0,0
166.09,2045,Single Family - Detached,1899,1884,15,0.00789889415481832
166.09,2050,Mobile Home,0,0,0,
166.09,2050,Multifamily,262,262,0,0
166.09,2050,Single Family - Detached,1899,1883,16,0.00842548709847288
166.10,2012,Mobile Home,0,0,0,
166.10,2012,Multifamily,400,371,29,0.0725
166.10,2012,Single Family - Detached,1103,1084,19,0.0172257479601088
166.10,2020,Mobile Home,0,0,0,
166.10,2020,Multifamily,400,371,29,0.0725
166.10,2020,Single Family - Detached,1108,1093,15,0.0135379061371841
166.10,2025,Mobile Home,0,0,0,
166.10,2025,Multifamily,400,371,29,0.0725
166.10,2025,Single Family - Detached,1108,1093,15,0.0135379061371841
166.10,2030,Mobile Home,0,0,0,
166.10,2030,Multifamily,400,371,29,0.0725
166.10,2030,Single Family - Detached,1108,1093,15,0.0135379061371841
166.10,2035,Mobile Home,0,0,0,
166.10,2035,Multifamily,400,371,29,0.0725
166.10,2035,Single Family - Detached,1108,1093,15,0.0135379061371841
166.10,2040,Mobile Home,0,0,0,
166.10,2040,Multifamily,400,371,29,0.0725
166.10,2040,Single Family - Detached,1108,1093,15,0.0135379061371841
166.10,2045,Mobile Home,0,0,0,
166.10,2045,Multifamily,400,371,29,0.0725
166.10,2045,Single Family - Detached,1108,1093,15,0.0135379061371841
166.10,2050,Mobile Home,0,0,0,
166.10,2050,Multifamily,400,371,29,0.0725
166.10,2050,Single Family - Detached,1108,1093,15,0.0135379061371841
166.12,2012,Mobile Home,0,0,0,
166.12,2012,Multifamily,259,256,3,0.0115830115830116
166.12,2012,Single Family - Detached,1857,1853,4,0.00215401184706516
166.12,2020,Mobile Home,0,0,0,
166.12,2020,Multifamily,259,258,1,0.00386100386100386
166.12,2020,Single Family - Detached,1989,1984,5,0.00251382604323781
166.12,2025,Mobile Home,0,0,0,
166.12,2025,Multifamily,259,259,0,0
166.12,2025,Single Family - Detached,2049,2046,3,0.00146412884333821
166.12,2030,Mobile Home,0,0,0,
166.12,2030,Multifamily,259,259,0,0
166.12,2030,Single Family - Detached,2153,2150,3,0.0013934045517882
166.12,2035,Mobile Home,0,0,0,
166.12,2035,Multifamily,259,259,0,0
166.12,2035,Single Family - Detached,2153,2151,2,0.000928936367858802
166.12,2040,Mobile Home,0,0,0,
166.12,2040,Multifamily,259,259,0,0
166.12,2040,Single Family - Detached,2153,2148,5,0.002322340919647
166.12,2045,Mobile Home,0,0,0,
166.12,2045,Multifamily,259,259,0,0
166.12,2045,Single Family - Detached,2153,2146,7,0.00325127728750581
166.12,2050,Mobile Home,0,0,0,
166.12,2050,Multifamily,259,259,0,0
166.12,2050,Single Family - Detached,2153,2146,7,0.00325127728750581
166.13,2012,Mobile Home,0,0,0,
166.13,2012,Multifamily,180,176,4,0.0222222222222222
166.13,2012,Single Family - Detached,525,520,5,0.00952380952380952
166.13,2020,Mobile Home,0,0,0,
166.13,2020,Multifamily,180,180,0,0
166.13,2020,Single Family - Detached,526,520,6,0.0114068441064639
166.13,2025,Mobile Home,0,0,0,
166.13,2025,Multifamily,180,180,0,0
166.13,2025,Single Family - Detached,526,521,5,0.00950570342205323
166.13,2030,Mobile Home,0,0,0,
166.13,2030,Multifamily,180,180,0,0
166.13,2030,Single Family - Detached,526,521,5,0.00950570342205323
166.13,2035,Mobile Home,0,0,0,
166.13,2035,Multifamily,180,180,0,0
166.13,2035,Single Family - Detached,526,523,3,0.00570342205323194
166.13,2040,Mobile Home,0,0,0,
166.13,2040,Multifamily,180,178,2,0.0111111111111111
166.13,2040,Single Family - Detached,526,523,3,0.00570342205323194
166.13,2045,Mobile Home,0,0,0,
166.13,2045,Multifamily,180,178,2,0.0111111111111111
166.13,2045,Single Family - Detached,526,523,3,0.00570342205323194
166.13,2050,Mobile Home,0,0,0,
166.13,2050,Multifamily,180,178,2,0.0111111111111111
166.13,2050,Single Family - Detached,526,523,3,0.00570342205323194
166.14,2012,Mobile Home,0,0,0,
166.14,2012,Multifamily,360,360,0,0
166.14,2012,Single Family - Detached,1010,989,21,0.0207920792079208
166.14,2020,Mobile Home,0,0,0,
166.14,2020,Multifamily,360,360,0,0
166.14,2020,Single Family - Detached,1010,982,28,0.0277227722772277
166.14,2025,Mobile Home,0,0,0,
166.14,2025,Multifamily,364,364,0,0
166.14,2025,Single Family - Detached,1010,986,24,0.0237623762376238
166.14,2030,Mobile Home,0,0,0,
166.14,2030,Multifamily,364,362,2,0.00549450549450549
166.14,2030,Single Family - Detached,1010,986,24,0.0237623762376238
166.14,2035,Mobile Home,0,0,0,
166.14,2035,Multifamily,364,362,2,0.00549450549450549
166.14,2035,Single Family - Detached,1010,987,23,0.0227722772277228
166.14,2040,Mobile Home,0,0,0,
166.14,2040,Multifamily,364,358,6,0.0164835164835165
166.14,2040,Single Family - Detached,1010,985,25,0.0247524752475248
166.14,2045,Mobile Home,0,0,0,
166.14,2045,Multifamily,364,354,10,0.0274725274725275
166.14,2045,Single Family - Detached,1010,983,27,0.0267326732673267
166.14,2050,Mobile Home,0,0,0,
166.14,2050,Multifamily,364,354,10,0.0274725274725275
166.14,2050,Single Family - Detached,1010,983,27,0.0267326732673267
166.15,2012,Mobile Home,0,0,0,
166.15,2012,Multifamily,347,337,10,0.0288184438040346
166.15,2012,Single Family - Detached,571,553,18,0.031523642732049
166.15,2020,Mobile Home,0,0,0,
166.15,2020,Multifamily,519,505,14,0.0269749518304432
166.15,2020,Single Family - Detached,572,560,12,0.020979020979021
166.15,2025,Mobile Home,0,0,0,
166.15,2025,Multifamily,830,813,17,0.0204819277108434
166.15,2025,Single Family - Detached,571,563,8,0.0140105078809107
166.15,2030,Mobile Home,0,0,0,
166.15,2030,Multifamily,970,952,18,0.0185567010309278
166.15,2030,Single Family - Detached,570,561,9,0.0157894736842105
166.15,2035,Mobile Home,0,0,0,
166.15,2035,Multifamily,1090,1073,17,0.0155963302752294
166.15,2035,Single Family - Detached,569,562,7,0.0123022847100176
166.15,2040,Mobile Home,0,0,0,
166.15,2040,Multifamily,1353,1328,25,0.0184774575018477
166.15,2040,Single Family - Detached,579,570,9,0.0155440414507772
166.15,2045,Mobile Home,0,0,0,
166.15,2045,Multifamily,1501,1473,28,0.0186542305129913
166.15,2045,Single Family - Detached,578,567,11,0.0190311418685121
166.15,2050,Mobile Home,0,0,0,
166.15,2050,Multifamily,1501,1473,28,0.0186542305129913
166.15,2050,Single Family - Detached,578,567,11,0.0190311418685121
166.16,2012,Mobile Home,133,133,0,0
166.16,2012,Multifamily,224,219,5,0.0223214285714286
166.16,2012,Single Family - Detached,1071,1025,46,0.0429505135387488
166.16,2020,Mobile Home,133,133,0,0
166.16,2020,Multifamily,286,282,4,0.013986013986014
166.16,2020,Single Family - Detached,1115,1071,44,0.0394618834080717
166.16,2025,Mobile Home,133,133,0,0
166.16,2025,Multifamily,306,305,1,0.00326797385620915
166.16,2025,Single Family - Detached,1106,1069,37,0.0334538878842676
166.16,2030,Mobile Home,133,132,1,0.0075187969924812
166.16,2030,Multifamily,312,309,3,0.00961538461538462
166.16,2030,Single Family - Detached,1103,1065,38,0.0344514959202176
166.16,2035,Mobile Home,133,132,1,0.0075187969924812
166.16,2035,Multifamily,312,310,2,0.00641025641025641
166.16,2035,Single Family - Detached,1104,1069,35,0.0317028985507246
166.16,2040,Mobile Home,133,132,1,0.0075187969924812
166.16,2040,Multifamily,412,395,17,0.0412621359223301
166.16,2040,Single Family - Detached,1122,1084,38,0.0338680926916221
166.16,2045,Mobile Home,133,131,2,0.0150375939849624
166.16,2045,Multifamily,412,391,21,0.0509708737864078
166.16,2045,Single Family - Detached,1122,1081,41,0.036541889483066
166.16,2050,Mobile Home,133,128,5,0.037593984962406
166.16,2050,Multifamily,412,391,21,0.0509708737864078
166.16,2050,Single Family - Detached,1122,1079,43,0.0383244206773619
166.17,2012,Mobile Home,451,410,41,0.0909090909090909
166.17,2012,Multifamily,627,573,54,0.0861244019138756
166.17,2012,Single Family - Detached,450,449,1,0.00222222222222222
166.17,2020,Mobile Home,470,431,39,0.0829787234042553
166.17,2020,Multifamily,627,572,55,0.087719298245614
166.17,2020,Single Family - Detached,478,459,19,0.0397489539748954
166.17,2025,Mobile Home,470,429,41,0.0872340425531915
166.17,2025,Multifamily,627,573,54,0.0861244019138756
166.17,2025,Single Family - Detached,457,445,12,0.0262582056892779
166.17,2030,Mobile Home,470,424,46,0.0978723404255319
166.17,2030,Multifamily,627,573,54,0.0861244019138756
166.17,2030,Single Family - Detached,444,431,13,0.0292792792792793
166.17,2035,Mobile Home,470,426,44,0.0936170212765957
166.17,2035,Multifamily,627,574,53,0.0845295055821372
166.17,2035,Single Family - Detached,419,410,9,0.0214797136038186
166.17,2040,Mobile Home,470,429,41,0.0872340425531915
166.17,2040,Multifamily,662,624,38,0.0574018126888218
166.17,2040,Single Family - Detached,418,406,12,0.0287081339712919
166.17,2045,Mobile Home,470,425,45,0.0957446808510638
166.17,2045,Multifamily,668,629,39,0.0583832335329341
166.17,2045,Single Family - Detached,414,400,14,0.0338164251207729
166.17,2050,Mobile Home,470,412,58,0.123404255319149
166.17,2050,Multifamily,668,629,39,0.0583832335329341
166.17,2050,Single Family - Detached,413,399,14,0.0338983050847458
167.01,2012,Mobile Home,182,182,0,0
167.01,2012,Multifamily,1264,1248,16,0.0126582278481013
167.01,2012,Single Family - Detached,1938,1918,20,0.0103199174406605
167.01,2020,Mobile Home,182,182,0,0
167.01,2020,Multifamily,1714,1691,23,0.0134189031505251
167.01,2020,Single Family - Detached,2266,2224,42,0.0185348631950574
167.01,2025,Mobile Home,182,181,1,0.00549450549450549
167.01,2025,Multifamily,1819,1801,18,0.00989554700384827
167.01,2025,Single Family - Detached,2537,2507,30,0.0118249901458415
167.01,2030,Mobile Home,182,179,3,0.0164835164835165
167.01,2030,Multifamily,1873,1855,18,0.00961025093432995
167.01,2030,Single Family - Detached,2680,2621,59,0.0220149253731343
167.01,2035,Mobile Home,182,180,2,0.010989010989011
167.01,2035,Multifamily,1894,1876,18,0.00950369588173178
167.01,2035,Single Family - Detached,2680,2628,52,0.0194029850746269
167.01,2040,Mobile Home,182,181,1,0.00549450549450549
167.01,2040,Multifamily,2050,2027,23,0.011219512195122
167.01,2040,Single Family - Detached,2735,2669,66,0.0241316270566728
167.01,2045,Mobile Home,182,179,3,0.0164835164835165
167.01,2045,Multifamily,2355,2321,34,0.0144373673036093
167.01,2045,Single Family - Detached,2638,2548,90,0.0341167551175133
167.01,2050,Mobile Home,182,171,11,0.0604395604395604
167.01,2050,Multifamily,2355,2320,35,0.0148619957537155
167.01,2050,Single Family - Detached,2638,2542,96,0.0363912054586808
167.02,2012,Mobile Home,60,46,14,0.233333333333333
167.02,2012,Multifamily,1452,1398,54,0.0371900826446281
167.02,2012,Single Family - Detached,1275,1226,49,0.0384313725490196
167.02,2020,Mobile Home,15,14,1,0.0666666666666667
167.02,2020,Multifamily,1377,1340,37,0.0268700072621641
167.02,2020,Single Family - Detached,1314,1254,60,0.045662100456621
167.02,2025,Mobile Home,15,14,1,0.0666666666666667
167.02,2025,Multifamily,1377,1347,30,0.0217864923747277
167.02,2025,Single Family - Detached,1417,1376,41,0.0289343683839097
167.02,2030,Mobile Home,15,13,2,0.133333333333333
167.02,2030,Multifamily,1379,1348,31,0.0224800580130529
167.02,2030,Single Family - Detached,1421,1320,101,0.0710767065446868
167.02,2035,Mobile Home,15,14,1,0.0666666666666667
167.02,2035,Multifamily,1379,1349,30,0.0217548948513416
167.02,2035,Single Family - Detached,1421,1323,98,0.0689655172413793
167.02,2040,Mobile Home,15,15,0,0
167.02,2040,Multifamily,1385,1349,36,0.0259927797833935
167.02,2040,Single Family - Detached,1421,1303,118,0.0830401125967628
167.02,2045,Mobile Home,15,14,1,0.0666666666666667
167.02,2045,Multifamily,1707,1599,108,0.0632688927943761
167.02,2045,Single Family - Detached,1391,1263,128,0.092020129403307
167.02,2050,Mobile Home,15,11,4,0.266666666666667
167.02,2050,Multifamily,1707,1599,108,0.0632688927943761
167.02,2050,Single Family - Detached,1391,1259,132,0.0948957584471603
168.02,2012,Mobile Home,1374,1276,98,0.0713245997088792
168.02,2012,Multifamily,10,7,3,0.3
168.02,2012,Single Family - Detached,1521,1426,95,0.0624589086127548
168.02,2020,Mobile Home,1147,1065,82,0.0714908456843941
168.02,2020,Multifamily,3,3,0,0
168.02,2020,Single Family - Detached,1987,1856,131,0.0659285354806241
168.02,2025,Mobile Home,1147,1063,84,0.0732345248474281
168.02,2025,Multifamily,3,3,0,0
168.02,2025,Single Family - Detached,2676,2554,122,0.0455904334828102
168.02,2030,Mobile Home,1147,1058,89,0.0775937227550131
168.02,2030,Multifamily,3,2,1,0.333333333333333
168.02,2030,Single Family - Detached,2895,2749,146,0.0504317789291883
168.02,2035,Mobile Home,1147,1060,87,0.0758500435919791
168.02,2035,Multifamily,3,3,0,0
168.02,2035,Single Family - Detached,2899,2757,142,0.0489824077268023
168.02,2040,Mobile Home,1147,1062,85,0.0741063644289451
168.02,2040,Multifamily,3,3,0,0
168.02,2040,Single Family - Detached,2901,2744,157,0.0541192692175112
168.02,2045,Mobile Home,1147,1059,88,0.0767218831734961
168.02,2045,Multifamily,3,2,1,0.333333333333333
168.02,2045,Single Family - Detached,2903,2744,159,0.0547709266276266
168.02,2050,Mobile Home,1147,1042,105,0.0915431560592851
168.02,2050,Multifamily,3,1,2,0.666666666666667
168.02,2050,Single Family - Detached,2903,2733,170,0.0585601102307957
168.04,2012,Mobile Home,0,0,0,
168.04,2012,Multifamily,1706,1543,163,0.0955451348182884
168.04,2012,Single Family - Detached,1041,989,52,0.0499519692603266
168.04,2020,Mobile Home,0,0,0,
168.04,2020,Multifamily,1706,1536,170,0.0996483001172333
168.04,2020,Single Family - Detached,1041,967,74,0.0710854947166186
168.04,2025,Mobile Home,0,0,0,
168.04,2025,Multifamily,1692,1528,164,0.0969267139479905
168.04,2025,Single Family - Detached,1011,948,63,0.0623145400593472
168.04,2030,Mobile Home,0,0,0,
168.04,2030,Multifamily,1692,1527,165,0.0975177304964539
168.04,2030,Single Family - Detached,1001,945,56,0.0559440559440559
168.04,2035,Mobile Home,0,0,0,
168.04,2035,Multifamily,1692,1528,164,0.0969267139479905
168.04,2035,Single Family - Detached,1001,951,50,0.04995004995005
168.04,2040,Mobile Home,0,0,0,
168.04,2040,Multifamily,1692,1524,168,0.099290780141844
168.04,2040,Single Family - Detached,1002,948,54,0.0538922155688623
168.04,2045,Mobile Home,0,0,0,
168.04,2045,Multifamily,2293,2193,100,0.0436109899694723
168.04,2045,Single Family - Detached,877,834,43,0.0490307867730901
168.04,2050,Mobile Home,0,0,0,
168.04,2050,Multifamily,2293,2192,101,0.044047099869167
168.04,2050,Single Family - Detached,878,835,43,0.0489749430523918
168.06,2012,Mobile Home,395,395,0,0
168.06,2012,Multifamily,284,290,-6,-0.0211267605633803
168.06,2012,Single Family - Detached,780,748,32,0.041025641025641
168.06,2020,Mobile Home,395,392,3,0.00759493670886076
168.06,2020,Multifamily,288,292,-4,-0.0138888888888889
168.06,2020,Single Family - Detached,1366,1341,25,0.0183016105417277
168.06,2025,Mobile Home,395,392,3,0.00759493670886076
168.06,2025,Multifamily,290,295,-5,-0.0172413793103448
168.06,2025,Single Family - Detached,1397,1380,17,0.0121689334287759
168.06,2030,Mobile Home,395,389,6,0.0151898734177215
168.06,2030,Multifamily,290,294,-4,-0.0137931034482759
168.06,2030,Single Family - Detached,1397,1362,35,0.0250536864710093
168.06,2035,Mobile Home,395,392,3,0.00759493670886076
168.06,2035,Multifamily,290,295,-5,-0.0172413793103448
168.06,2035,Single Family - Detached,1397,1363,34,0.0243378668575519
168.06,2040,Mobile Home,395,392,3,0.00759493670886076
168.06,2040,Multifamily,290,294,-4,-0.0137931034482759
168.06,2040,Single Family - Detached,1397,1359,38,0.0272011453113815
168.06,2045,Mobile Home,395,389,6,0.0151898734177215
168.06,2045,Multifamily,307,297,10,0.0325732899022801
168.06,2045,Single Family - Detached,1397,1347,50,0.0357909806728704
168.06,2050,Mobile Home,395,380,15,0.0379746835443038
168.06,2050,Multifamily,307,297,10,0.0325732899022801
168.06,2050,Single Family - Detached,1397,1346,51,0.0365068002863278
168.07,2012,Mobile Home,622,593,29,0.0466237942122186
168.07,2012,Multifamily,190,172,18,0.0947368421052632
168.07,2012,Single Family - Detached,1789,1696,93,0.0519843487982113
168.07,2020,Mobile Home,622,594,28,0.045016077170418
168.07,2020,Multifamily,190,168,22,0.115789473684211
168.07,2020,Single Family - Detached,1941,1851,90,0.0463678516228748
168.07,2025,Mobile Home,622,594,28,0.045016077170418
168.07,2025,Multifamily,190,171,19,0.1
168.07,2025,Single Family - Detached,3258,3147,111,0.0340699815837937
168.07,2030,Mobile Home,622,599,23,0.0369774919614148
168.07,2030,Multifamily,190,171,19,0.1
168.07,2030,Single Family - Detached,3340,3195,145,0.0434131736526946
168.07,2035,Mobile Home,622,592,30,0.0482315112540193
168.07,2035,Multifamily,190,171,19,0.1
168.07,2035,Single Family - Detached,3367,3225,142,0.0421740421740422
168.07,2040,Mobile Home,622,592,30,0.0482315112540193
168.07,2040,Multifamily,190,167,23,0.121052631578947
168.07,2040,Single Family - Detached,3410,3259,151,0.0442815249266862
168.07,2045,Mobile Home,622,592,30,0.0482315112540193
168.07,2045,Multifamily,287,239,48,0.167247386759582
168.07,2045,Single Family - Detached,3399,3240,159,0.0467784642541924
168.07,2050,Mobile Home,622,586,36,0.0578778135048231
168.07,2050,Multifamily,287,239,48,0.167247386759582
168.07,2050,Single Family - Detached,3435,3272,163,0.04745269286754
168.09,2012,Mobile Home,664,591,73,0.109939759036145
168.09,2012,Multifamily,34,74,-40,-1.17647058823529
168.09,2012,Single Family - Detached,1332,1225,107,0.0803303303303303
168.09,2020,Mobile Home,664,589,75,0.112951807228916
168.09,2020,Multifamily,34,72,-38,-1.11764705882353
168.09,2020,Single Family - Detached,1368,1254,114,0.0833333333333333
168.09,2025,Mobile Home,664,589,75,0.112951807228916
168.09,2025,Multifamily,34,74,-40,-1.17647058823529
168.09,2025,Single Family - Detached,1435,1326,109,0.0759581881533101
168.09,2030,Mobile Home,664,592,72,0.108433734939759
168.09,2030,Multifamily,34,73,-39,-1.14705882352941
168.09,2030,Single Family - Detached,2052,1975,77,0.0375243664717349
168.09,2035,Mobile Home,595,567,28,0.0470588235294118
168.09,2035,Multifamily,34,74,-40,-1.17647058823529
168.09,2035,Single Family - Detached,2206,2134,72,0.0326382592928377
168.09,2040,Mobile Home,564,545,19,0.0336879432624113
168.09,2040,Multifamily,34,71,-37,-1.08823529411765
168.09,2040,Single Family - Detached,2286,2212,74,0.0323709536307962
168.09,2045,Mobile Home,534,513,21,0.0393258426966292
168.09,2045,Multifamily,51,63,-12,-0.235294117647059
168.09,2045,Single Family - Detached,2354,2270,84,0.0356839422259983
168.09,2050,Mobile Home,503,473,30,0.0596421471172962
168.09,2050,Multifamily,51,61,-10,-0.196078431372549
168.09,2050,Single Family - Detached,2354,2269,85,0.0361087510620221
168.10,2012,Mobile Home,0,0,0,
168.10,2012,Multifamily,1,0,1,1
168.10,2012,Single Family - Detached,914,896,18,0.0196936542669584
168.10,2020,Mobile Home,0,0,0,
168.10,2020,Multifamily,1,0,1,1
168.10,2020,Single Family - Detached,914,893,21,0.0229759299781182
168.10,2025,Mobile Home,0,0,0,
168.10,2025,Multifamily,1,1,0,0
168.10,2025,Single Family - Detached,923,902,21,0.0227518959913326
168.10,2030,Mobile Home,0,0,0,
168.10,2030,Multifamily,1,0,1,1
168.10,2030,Single Family - Detached,1082,1070,12,0.011090573012939
168.10,2035,Mobile Home,0,0,0,
168.10,2035,Multifamily,1,1,0,0
168.10,2035,Single Family - Detached,1082,1070,12,0.011090573012939
168.10,2040,Mobile Home,0,0,0,
168.10,2040,Multifamily,1,0,1,1
168.10,2040,Single Family - Detached,1083,1072,11,0.0101569713758079
168.10,2045,Mobile Home,0,0,0,
168.10,2045,Multifamily,1,0,1,1
168.10,2045,Single Family - Detached,1083,1067,16,0.0147737765466297
168.10,2050,Mobile Home,0,0,0,
168.10,2050,Multifamily,1,0,1,1
168.10,2050,Single Family - Detached,1083,1067,16,0.0147737765466297
168.11,2012,Mobile Home,580,505,75,0.129310344827586
168.11,2012,Multifamily,0,0,0,
168.11,2012,Single Family - Detached,1139,1089,50,0.0438981562774363
168.11,2020,Mobile Home,580,502,78,0.13448275862069
168.11,2020,Multifamily,0,0,0,
168.11,2020,Single Family - Detached,1139,1078,61,0.0535557506584723
168.11,2025,Mobile Home,580,500,80,0.137931034482759
168.11,2025,Multifamily,0,0,0,
168.11,2025,Single Family - Detached,1139,1079,60,0.0526777875329236
168.11,2030,Mobile Home,580,497,83,0.143103448275862
168.11,2030,Multifamily,0,0,0,
168.11,2030,Single Family - Detached,1811,1780,31,0.0171176145775814
168.11,2035,Mobile Home,566,488,78,0.137809187279152
168.11,2035,Multifamily,0,0,0,
168.11,2035,Single Family - Detached,1968,1941,27,0.013719512195122
168.11,2040,Mobile Home,566,490,76,0.134275618374558
168.11,2040,Multifamily,0,0,0,
168.11,2040,Single Family - Detached,2159,2129,30,0.0138953219082909
168.11,2045,Mobile Home,566,488,78,0.137809187279152
168.11,2045,Multifamily,0,0,0,
168.11,2045,Single Family - Detached,2355,2313,42,0.0178343949044586
168.11,2050,Mobile Home,566,478,88,0.15547703180212
168.11,2050,Multifamily,0,0,0,
168.11,2050,Single Family - Detached,2356,2315,41,0.017402376910017
169.01,2012,Mobile Home,445,444,1,0.00224719101123596
169.01,2012,Multifamily,11,0,11,1
169.01,2012,Single Family - Detached,2016,2027,-11,-0.00545634920634921
169.01,2020,Mobile Home,445,445,0,0
169.01,2020,Multifamily,11,4,7,0.636363636363636
169.01,2020,Single Family - Detached,2575,2526,49,0.0190291262135922
169.01,2025,Mobile Home,445,444,1,0.00224719101123596
169.01,2025,Multifamily,11,4,7,0.636363636363636
169.01,2025,Single Family - Detached,2659,2622,37,0.0139150056412185
169.01,2030,Mobile Home,445,441,4,0.00898876404494382
169.01,2030,Multifamily,11,4,7,0.636363636363636
169.01,2030,Single Family - Detached,2755,2716,39,0.0141560798548094
169.01,2035,Mobile Home,445,441,4,0.00898876404494382
169.01,2035,Multifamily,11,4,7,0.636363636363636
169.01,2035,Single Family - Detached,2854,2817,37,0.0129642606867554
169.01,2040,Mobile Home,445,442,3,0.00674157303370787
169.01,2040,Multifamily,11,4,7,0.636363636363636
169.01,2040,Single Family - Detached,2988,2946,42,0.0140562248995984
169.01,2045,Mobile Home,445,440,5,0.0112359550561798
169.01,2045,Multifamily,11,4,7,0.636363636363636
169.01,2045,Single Family - Detached,3117,3066,51,0.0163618864292589
169.01,2050,Mobile Home,445,431,14,0.0314606741573034
169.01,2050,Multifamily,11,4,7,0.636363636363636
169.01,2050,Single Family - Detached,3157,3100,57,0.0180551156160912
169.02,2012,Mobile Home,0,0,0,
169.02,2012,Multifamily,32,38,-6,-0.1875
169.02,2012,Single Family - Detached,757,678,79,0.104359313077939
169.02,2020,Mobile Home,0,0,0,
169.02,2020,Multifamily,32,39,-7,-0.21875
169.02,2020,Single Family - Detached,779,748,31,0.0397946084724005
169.02,2025,Mobile Home,0,0,0,
169.02,2025,Multifamily,32,39,-7,-0.21875
169.02,2025,Single Family - Detached,779,754,25,0.0320924261874198
169.02,2030,Mobile Home,0,0,0,
169.02,2030,Multifamily,32,39,-7,-0.21875
169.02,2030,Single Family - Detached,1018,986,32,0.031434184675835
169.02,2035,Mobile Home,0,0,0,
169.02,2035,Multifamily,32,39,-7,-0.21875
169.02,2035,Single Family - Detached,1079,1052,27,0.0250231696014829
169.02,2040,Mobile Home,0,0,0,
169.02,2040,Multifamily,32,39,-7,-0.21875
169.02,2040,Single Family - Detached,1115,1081,34,0.0304932735426009
169.02,2045,Mobile Home,0,0,0,
169.02,2045,Multifamily,32,39,-7,-0.21875
169.02,2045,Single Family - Detached,1135,1097,38,0.0334801762114537
169.02,2050,Mobile Home,0,0,0,
169.02,2050,Multifamily,32,39,-7,-0.21875
169.02,2050,Single Family - Detached,1144,1106,38,0.0332167832167832
17,2012,Mobile Home,0,0,0,
17,2012,Multifamily,1299,1245,54,0.0415704387990762
17,2012,Single Family - Detached,1027,979,48,0.0467380720545277
17,2020,Mobile Home,0,0,0,
17,2020,Multifamily,1299,1225,74,0.0569668976135489
17,2020,Single Family - Detached,1029,977,52,0.0505344995140913
17,2025,Mobile Home,0,0,0,
17,2025,Multifamily,1342,1262,80,0.0596125186289121
17,2025,Single Family - Detached,1011,969,42,0.0415430267062315
17,2030,Mobile Home,0,0,0,
17,2030,Multifamily,1616,1522,94,0.0581683168316832
17,2030,Single Family - Detached,972,933,39,0.0401234567901235
17,2035,Mobile Home,0,0,0,
17,2035,Multifamily,1834,1727,107,0.0583424209378408
17,2035,Single Family - Detached,946,913,33,0.0348837209302326
17,2040,Mobile Home,0,0,0,
17,2040,Multifamily,1893,1766,127,0.0670892762810354
17,2040,Single Family - Detached,928,894,34,0.0366379310344828
17,2045,Mobile Home,0,0,0,
17,2045,Multifamily,1893,1757,136,0.0718436344426836
17,2045,Single Family - Detached,931,896,35,0.037593984962406
17,2050,Mobile Home,0,0,0,
17,2050,Multifamily,1893,1755,138,0.0729001584786054
17,2050,Single Family - Detached,931,896,35,0.037593984962406
170.06,2012,Mobile Home,0,0,0,
170.06,2012,Multifamily,0,0,0,
170.06,2012,Single Family - Detached,1058,1048,10,0.00945179584120983
170.06,2020,Mobile Home,0,0,0,
170.06,2020,Multifamily,0,0,0,
170.06,2020,Single Family - Detached,1058,1046,12,0.0113421550094518
170.06,2025,Mobile Home,0,0,0,
170.06,2025,Multifamily,0,0,0,
170.06,2025,Single Family - Detached,1058,1046,12,0.0113421550094518
170.06,2030,Mobile Home,0,0,0,
170.06,2030,Multifamily,0,0,0,
170.06,2030,Single Family - Detached,1058,1046,12,0.0113421550094518
170.06,2035,Mobile Home,0,0,0,
170.06,2035,Multifamily,0,0,0,
170.06,2035,Single Family - Detached,1058,1046,12,0.0113421550094518
170.06,2040,Mobile Home,0,0,0,
170.06,2040,Multifamily,0,0,0,
170.06,2040,Single Family - Detached,1058,1046,12,0.0113421550094518
170.06,2045,Mobile Home,0,0,0,
170.06,2045,Multifamily,0,0,0,
170.06,2045,Single Family - Detached,1058,1046,12,0.0113421550094518
170.06,2050,Mobile Home,0,0,0,
170.06,2050,Multifamily,0,0,0,
170.06,2050,Single Family - Detached,1058,1046,12,0.0113421550094518
170.09,2012,Mobile Home,262,258,4,0.0152671755725191
170.09,2012,Multifamily,362,352,10,0.0276243093922652
170.09,2012,Single Family - Detached,860,806,54,0.0627906976744186
170.09,2020,Mobile Home,262,259,3,0.0114503816793893
170.09,2020,Multifamily,362,354,8,0.0220994475138122
170.09,2020,Single Family - Detached,874,818,56,0.0640732265446224
170.09,2025,Mobile Home,262,259,3,0.0114503816793893
170.09,2025,Multifamily,364,360,4,0.010989010989011
170.09,2025,Single Family - Detached,874,825,49,0.0560640732265446
170.09,2030,Mobile Home,262,257,5,0.0190839694656489
170.09,2030,Multifamily,364,360,4,0.010989010989011
170.09,2030,Single Family - Detached,877,827,50,0.0570125427594071
170.09,2035,Mobile Home,262,257,5,0.0190839694656489
170.09,2035,Multifamily,364,360,4,0.010989010989011
170.09,2035,Single Family - Detached,901,864,37,0.0410654827968923
170.09,2040,Mobile Home,262,258,4,0.0152671755725191
170.09,2040,Multifamily,364,359,5,0.0137362637362637
170.09,2040,Single Family - Detached,901,863,38,0.0421753607103219
170.09,2045,Mobile Home,262,257,5,0.0190839694656489
170.09,2045,Multifamily,364,359,5,0.0137362637362637
170.09,2045,Single Family - Detached,901,863,38,0.0421753607103219
170.09,2050,Mobile Home,262,252,10,0.0381679389312977
170.09,2050,Multifamily,364,359,5,0.0137362637362637
170.09,2050,Single Family - Detached,901,863,38,0.0421753607103219
170.10,2012,Mobile Home,0,0,0,
170.10,2012,Multifamily,0,0,0,
170.10,2012,Single Family - Detached,1013,1013,0,0
170.10,2020,Mobile Home,0,0,0,
170.10,2020,Multifamily,0,0,0,
170.10,2020,Single Family - Detached,1083,1082,1,0.000923361034164358
170.10,2025,Mobile Home,0,0,0,
170.10,2025,Multifamily,0,0,0,
170.10,2025,Single Family - Detached,1089,1089,0,0
170.10,2030,Mobile Home,0,0,0,
170.10,2030,Multifamily,0,0,0,
170.10,2030,Single Family - Detached,1096,1096,0,0
170.10,2035,Mobile Home,0,0,0,
170.10,2035,Multifamily,0,0,0,
170.10,2035,Single Family - Detached,1153,1153,0,0
170.10,2040,Mobile Home,0,0,0,
170.10,2040,Multifamily,0,0,0,
170.10,2040,Single Family - Detached,1153,1151,2,0.00173460537727667
170.10,2045,Mobile Home,0,0,0,
170.10,2045,Multifamily,0,0,0,
170.10,2045,Single Family - Detached,1153,1150,3,0.002601908065915
170.10,2050,Mobile Home,0,0,0,
170.10,2050,Multifamily,0,0,0,
170.10,2050,Single Family - Detached,1153,1150,3,0.002601908065915
170.14,2012,Mobile Home,0,0,0,
170.14,2012,Multifamily,353,321,32,0.0906515580736544
170.14,2012,Single Family - Detached,1376,1310,66,0.0479651162790698
170.14,2020,Mobile Home,0,0,0,
170.14,2020,Multifamily,353,322,31,0.0878186968838527
170.14,2020,Single Family - Detached,1376,1298,78,0.0566860465116279
170.14,2025,Mobile Home,0,0,0,
170.14,2025,Multifamily,355,347,8,0.0225352112676056
170.14,2025,Single Family - Detached,1376,1301,75,0.0545058139534884
170.14,2030,Mobile Home,0,0,0,
170.14,2030,Multifamily,355,347,8,0.0225352112676056
170.14,2030,Single Family - Detached,1376,1301,75,0.0545058139534884
170.14,2035,Mobile Home,0,0,0,
170.14,2035,Multifamily,355,348,7,0.0197183098591549
170.14,2035,Single Family - Detached,1376,1303,73,0.0530523255813953
170.14,2040,Mobile Home,0,0,0,
170.14,2040,Multifamily,355,347,8,0.0225352112676056
170.14,2040,Single Family - Detached,1376,1300,76,0.0552325581395349
170.14,2045,Mobile Home,0,0,0,
170.14,2045,Multifamily,355,347,8,0.0225352112676056
170.14,2045,Single Family - Detached,1376,1298,78,0.0566860465116279
170.14,2050,Mobile Home,0,0,0,
170.14,2050,Multifamily,355,347,8,0.0225352112676056
170.14,2050,Single Family - Detached,1376,1298,78,0.0566860465116279
170.15,2012,Mobile Home,0,0,0,
170.15,2012,Multifamily,524,524,0,0
170.15,2012,Single Family - Detached,2699,2584,115,0.0426083734716562
170.15,2020,Mobile Home,0,0,0,
170.15,2020,Multifamily,525,525,0,0
170.15,2020,Single Family - Detached,2699,2576,123,0.0455724342349018
170.15,2025,Mobile Home,0,0,0,
170.15,2025,Multifamily,526,526,0,0
170.15,2025,Single Family - Detached,2699,2590,109,0.0403853278992219
170.15,2030,Mobile Home,0,0,0,
170.15,2030,Multifamily,526,526,0,0
170.15,2030,Single Family - Detached,2699,2589,110,0.0407558354946276
170.15,2035,Mobile Home,0,0,0,
170.15,2035,Multifamily,526,526,0,0
170.15,2035,Single Family - Detached,2699,2595,104,0.0385327899221934
170.15,2040,Mobile Home,0,0,0,
170.15,2040,Multifamily,526,524,2,0.00380228136882129
170.15,2040,Single Family - Detached,2699,2591,108,0.0400148203038162
170.15,2045,Mobile Home,0,0,0,
170.15,2045,Multifamily,526,524,2,0.00380228136882129
170.15,2045,Single Family - Detached,2699,2587,112,0.0414968506854391
170.15,2050,Mobile Home,0,0,0,
170.15,2050,Multifamily,526,524,2,0.00380228136882129
170.15,2050,Single Family - Detached,2699,2583,116,0.0429788810670619
170.18,2012,Mobile Home,0,0,0,
170.18,2012,Multifamily,1532,1501,31,0.0202349869451697
170.18,2012,Single Family - Detached,201,142,59,0.293532338308458
170.18,2020,Mobile Home,0,0,0,
170.18,2020,Multifamily,1532,1501,31,0.0202349869451697
170.18,2020,Single Family - Detached,201,142,59,0.293532338308458
170.18,2025,Mobile Home,0,0,0,
170.18,2025,Multifamily,1534,1506,28,0.0182529335071708
170.18,2025,Single Family - Detached,201,143,58,0.288557213930348
170.18,2030,Mobile Home,0,0,0,
170.18,2030,Multifamily,1534,1506,28,0.0182529335071708
170.18,2030,Single Family - Detached,201,143,58,0.288557213930348
170.18,2035,Mobile Home,0,0,0,
170.18,2035,Multifamily,1534,1506,28,0.0182529335071708
170.18,2035,Single Family - Detached,201,144,57,0.283582089552239
170.18,2040,Mobile Home,0,0,0,
170.18,2040,Multifamily,1534,1505,29,0.0189048239895698
170.18,2040,Single Family - Detached,201,144,57,0.283582089552239
170.18,2045,Mobile Home,0,0,0,
170.18,2045,Multifamily,1534,1505,29,0.0189048239895698
170.18,2045,Single Family - Detached,201,144,57,0.283582089552239
170.18,2050,Mobile Home,0,0,0,
170.18,2050,Multifamily,1534,1505,29,0.0189048239895698
170.18,2050,Single Family - Detached,201,144,57,0.283582089552239
170.19,2012,Mobile Home,0,0,0,
170.19,2012,Multifamily,216,215,1,0.00462962962962963
170.19,2012,Single Family - Detached,2931,2855,76,0.0259297168201979
170.19,2020,Mobile Home,0,0,0,
170.19,2020,Multifamily,216,216,0,0
170.19,2020,Single Family - Detached,2932,2844,88,0.0300136425648022
170.19,2025,Mobile Home,0,0,0,
170.19,2025,Multifamily,216,216,0,0
170.19,2025,Single Family - Detached,2943,2883,60,0.0203873598369011
170.19,2030,Mobile Home,0,0,0,
170.19,2030,Multifamily,216,216,0,0
170.19,2030,Single Family - Detached,2954,2891,63,0.0213270142180095
170.19,2035,Mobile Home,0,0,0,
170.19,2035,Multifamily,216,216,0,0
170.19,2035,Single Family - Detached,2956,2902,54,0.0182679296346414
170.19,2040,Mobile Home,0,0,0,
170.19,2040,Multifamily,216,216,0,0
170.19,2040,Single Family - Detached,2971,2904,67,0.0225513295186806
170.19,2045,Mobile Home,0,0,0,
170.19,2045,Multifamily,216,216,0,0
170.19,2045,Single Family - Detached,2977,2894,83,0.0278804165267047
170.19,2050,Mobile Home,0,0,0,
170.19,2050,Multifamily,216,216,0,0
170.19,2050,Single Family - Detached,3001,2915,86,0.0286571142952349
170.20,2012,Mobile Home,0,0,0,
170.20,2012,Multifamily,1,0,1,1
170.20,2012,Single Family - Detached,1392,1374,18,0.0129310344827586
170.20,2020,Mobile Home,0,0,0,
170.20,2020,Multifamily,1,1,0,0
170.20,2020,Single Family - Detached,1525,1510,15,0.00983606557377049
170.20,2025,Mobile Home,0,0,0,
170.20,2025,Multifamily,1,1,0,0
170.20,2025,Single Family - Detached,1531,1519,12,0.00783801436969301
170.20,2030,Mobile Home,0,0,0,
170.20,2030,Multifamily,1,0,1,1
170.20,2030,Single Family - Detached,1537,1525,12,0.00780741704619388
170.20,2035,Mobile Home,0,0,0,
170.20,2035,Multifamily,1,1,0,0
170.20,2035,Single Family - Detached,1560,1549,11,0.00705128205128205
170.20,2040,Mobile Home,0,0,0,
170.20,2040,Multifamily,1,0,1,1
170.20,2040,Single Family - Detached,1560,1547,13,0.00833333333333333
170.20,2045,Mobile Home,0,0,0,
170.20,2045,Multifamily,1,0,1,1
170.20,2045,Single Family - Detached,1560,1546,14,0.00897435897435897
170.20,2050,Mobile Home,0,0,0,
170.20,2050,Multifamily,1,0,1,1
170.20,2050,Single Family - Detached,1560,1547,13,0.00833333333333333
170.21,2012,Mobile Home,0,0,0,
170.21,2012,Multifamily,0,0,0,
170.21,2012,Single Family - Detached,1075,1075,0,0
170.21,2020,Mobile Home,0,0,0,
170.21,2020,Multifamily,0,0,0,
170.21,2020,Single Family - Detached,1175,1166,9,0.00765957446808511
170.21,2025,Mobile Home,0,0,0,
170.21,2025,Multifamily,0,0,0,
170.21,2025,Single Family - Detached,1180,1177,3,0.00254237288135593
170.21,2030,Mobile Home,0,0,0,
170.21,2030,Multifamily,0,0,0,
170.21,2030,Single Family - Detached,1188,1184,4,0.00336700336700337
170.21,2035,Mobile Home,0,0,0,
170.21,2035,Multifamily,0,0,0,
170.21,2035,Single Family - Detached,1226,1224,2,0.00163132137030995
170.21,2040,Mobile Home,0,0,0,
170.21,2040,Multifamily,0,0,0,
170.21,2040,Single Family - Detached,1226,1221,5,0.00407830342577488
170.21,2045,Mobile Home,0,0,0,
170.21,2045,Multifamily,0,0,0,
170.21,2045,Single Family - Detached,1226,1219,7,0.00570962479608483
170.21,2050,Mobile Home,0,0,0,
170.21,2050,Multifamily,0,0,0,
170.21,2050,Single Family - Detached,1226,1219,7,0.00570962479608483
170.22,2012,Mobile Home,0,0,0,
170.22,2012,Multifamily,384,384,0,0
170.22,2012,Single Family - Detached,1830,1787,43,0.0234972677595628
170.22,2020,Mobile Home,0,0,0,
170.22,2020,Multifamily,434,434,0,0
170.22,2020,Single Family - Detached,1831,1785,46,0.0251228836701256
170.22,2025,Mobile Home,0,0,0,
170.22,2025,Multifamily,529,529,0,0
170.22,2025,Single Family - Detached,1832,1794,38,0.0207423580786026
170.22,2030,Mobile Home,0,0,0,
170.22,2030,Multifamily,582,582,0,0
170.22,2030,Single Family - Detached,1832,1793,39,0.0212882096069869
170.22,2035,Mobile Home,0,0,0,
170.22,2035,Multifamily,610,610,0,0
170.22,2035,Single Family - Detached,1832,1796,36,0.0196506550218341
170.22,2040,Mobile Home,0,0,0,
170.22,2040,Multifamily,922,921,1,0.00108459869848156
170.22,2040,Single Family - Detached,1832,1793,39,0.0212882096069869
170.22,2045,Mobile Home,0,0,0,
170.22,2045,Multifamily,1205,1203,2,0.0016597510373444
170.22,2045,Single Family - Detached,1832,1792,40,0.0218340611353712
170.22,2050,Mobile Home,0,0,0,
170.22,2050,Multifamily,1205,1203,2,0.0016597510373444
170.22,2050,Single Family - Detached,1832,1791,41,0.0223799126637555
170.29,2012,Mobile Home,0,0,0,
170.29,2012,Multifamily,258,282,-24,-0.0930232558139535
170.29,2012,Single Family - Detached,3187,2914,273,0.0856604957640414
170.29,2020,Mobile Home,0,0,0,
170.29,2020,Multifamily,258,284,-26,-0.10077519379845
170.29,2020,Single Family - Detached,3487,3168,319,0.0914826498422713
170.29,2025,Mobile Home,0,0,0,
170.29,2025,Multifamily,258,284,-26,-0.10077519379845
170.29,2025,Single Family - Detached,3619,3392,227,0.0627245095330202
170.29,2030,Mobile Home,0,0,0,
170.29,2030,Multifamily,258,284,-26,-0.10077519379845
170.29,2030,Single Family - Detached,3638,3425,213,0.0585486531061023
170.29,2035,Mobile Home,0,0,0,
170.29,2035,Multifamily,258,284,-26,-0.10077519379845
170.29,2035,Single Family - Detached,3638,3437,201,0.0552501374381528
170.29,2040,Mobile Home,0,0,0,
170.29,2040,Multifamily,258,278,-20,-0.0775193798449612
170.29,2040,Single Family - Detached,3644,3415,229,0.0628430296377607
170.29,2045,Mobile Home,0,0,0,
170.29,2045,Multifamily,258,276,-18,-0.0697674418604651
170.29,2045,Single Family - Detached,3644,3382,262,0.0718990120746432
170.29,2050,Mobile Home,0,0,0,
170.29,2050,Multifamily,258,274,-16,-0.062015503875969
170.29,2050,Single Family - Detached,3648,3373,275,0.0753837719298246
170.30,2012,Mobile Home,0,0,0,
170.30,2012,Multifamily,2263,2206,57,0.0251878038002651
170.30,2012,Single Family - Detached,4556,4422,134,0.0294117647058824
170.30,2020,Mobile Home,0,0,0,
170.30,2020,Multifamily,3142,3086,56,0.0178230426479949
170.30,2020,Single Family - Detached,5616,5445,171,0.0304487179487179
170.30,2025,Mobile Home,0,0,0,
170.30,2025,Multifamily,3142,3087,55,0.0175047740292807
170.30,2025,Single Family - Detached,5669,5509,160,0.0282236726053978
170.30,2030,Mobile Home,0,0,0,
170.30,2030,Multifamily,3142,3087,55,0.0175047740292807
170.30,2030,Single Family - Detached,5849,5662,187,0.0319712771413917
170.30,2035,Mobile Home,0,0,0,
170.30,2035,Multifamily,3142,3088,54,0.0171865054105665
170.30,2035,Single Family - Detached,5850,5670,180,0.0307692307692308
170.30,2040,Mobile Home,0,0,0,
170.30,2040,Multifamily,3142,3087,55,0.0175047740292807
170.30,2040,Single Family - Detached,5985,5787,198,0.0330827067669173
170.30,2045,Mobile Home,0,0,0,
170.30,2045,Multifamily,3142,3087,55,0.0175047740292807
170.30,2045,Single Family - Detached,6084,5869,215,0.0353385930309007
170.30,2050,Mobile Home,0,0,0,
170.30,2050,Multifamily,3142,3087,55,0.0175047740292807
170.30,2050,Single Family - Detached,6105,5884,221,0.0361998361998362
170.31,2012,Mobile Home,0,0,0,
170.31,2012,Multifamily,391,391,0,0
170.31,2012,Single Family - Detached,1052,1002,50,0.0475285171102662
170.31,2020,Mobile Home,0,0,0,
170.31,2020,Multifamily,392,392,0,0
170.31,2020,Single Family - Detached,1052,994,58,0.0551330798479087
170.31,2025,Mobile Home,0,0,0,
170.31,2025,Multifamily,393,393,0,0
170.31,2025,Single Family - Detached,1052,1001,51,0.0484790874524715
170.31,2030,Mobile Home,0,0,0,
170.31,2030,Multifamily,393,393,0,0
170.31,2030,Single Family - Detached,1052,999,53,0.0503802281368821
170.31,2035,Mobile Home,0,0,0,
170.31,2035,Multifamily,393,393,0,0
170.31,2035,Single Family - Detached,1052,1002,50,0.0475285171102662
170.31,2040,Mobile Home,0,0,0,
170.31,2040,Multifamily,393,393,0,0
170.31,2040,Single Family - Detached,1052,1000,52,0.0494296577946768
170.31,2045,Mobile Home,0,0,0,
170.31,2045,Multifamily,393,393,0,0
170.31,2045,Single Family - Detached,1052,998,54,0.0513307984790875
170.31,2050,Mobile Home,0,0,0,
170.31,2050,Multifamily,393,393,0,0
170.31,2050,Single Family - Detached,1052,998,54,0.0513307984790875
170.32,2012,Mobile Home,0,0,0,
170.32,2012,Multifamily,1570,1492,78,0.0496815286624204
170.32,2012,Single Family - Detached,2844,2770,74,0.0260196905766526
170.32,2020,Mobile Home,0,0,0,
170.32,2020,Multifamily,1570,1496,74,0.0471337579617834
170.32,2020,Single Family - Detached,2844,2759,85,0.029887482419128
170.32,2025,Mobile Home,0,0,0,
170.32,2025,Multifamily,1570,1497,73,0.0464968152866242
170.32,2025,Single Family - Detached,2844,2766,78,0.0274261603375527
170.32,2030,Mobile Home,0,0,0,
170.32,2030,Multifamily,1570,1497,73,0.0464968152866242
170.32,2030,Single Family - Detached,2844,2762,82,0.0288326300984529
170.32,2035,Mobile Home,0,0,0,
170.32,2035,Multifamily,1570,1498,72,0.045859872611465
170.32,2035,Single Family - Detached,2844,2765,79,0.0277777777777778
170.32,2040,Mobile Home,0,0,0,
170.32,2040,Multifamily,1570,1493,77,0.0490445859872611
170.32,2040,Single Family - Detached,2844,2762,82,0.0288326300984529
170.32,2045,Mobile Home,0,0,0,
170.32,2045,Multifamily,1570,1492,78,0.0496815286624204
170.32,2045,Single Family - Detached,2844,2757,87,0.0305907172995781
170.32,2050,Mobile Home,0,0,0,
170.32,2050,Multifamily,1570,1491,79,0.0503184713375796
170.32,2050,Single Family - Detached,2844,2757,87,0.0305907172995781
170.33,2012,Mobile Home,0,0,0,
170.33,2012,Multifamily,363,332,31,0.0853994490358127
170.33,2012,Single Family - Detached,1249,1243,6,0.00480384307445957
170.33,2020,Mobile Home,0,0,0,
170.33,2020,Multifamily,363,332,31,0.0853994490358127
170.33,2020,Single Family - Detached,1649,1628,21,0.0127349909035779
170.33,2025,Mobile Home,0,0,0,
170.33,2025,Multifamily,363,335,28,0.0771349862258953
170.33,2025,Single Family - Detached,1649,1632,17,0.0103092783505155
170.33,2030,Mobile Home,0,0,0,
170.33,2030,Multifamily,363,335,28,0.0771349862258953
170.33,2030,Single Family - Detached,1649,1632,17,0.0103092783505155
170.33,2035,Mobile Home,0,0,0,
170.33,2035,Multifamily,363,336,27,0.0743801652892562
170.33,2035,Single Family - Detached,1649,1633,16,0.00970285021224985
170.33,2040,Mobile Home,0,0,0,
170.33,2040,Multifamily,363,333,30,0.0826446280991736
170.33,2040,Single Family - Detached,1649,1632,17,0.0103092783505155
170.33,2045,Mobile Home,0,0,0,
170.33,2045,Multifamily,363,331,32,0.0881542699724518
170.33,2045,Single Family - Detached,1649,1631,18,0.0109157064887811
170.33,2050,Mobile Home,0,0,0,
170.33,2050,Multifamily,363,329,34,0.09366391184573
170.33,2050,Single Family - Detached,1649,1631,18,0.0109157064887811
170.34,2012,Mobile Home,0,0,0,
170.34,2012,Multifamily,568,518,50,0.0880281690140845
170.34,2012,Single Family - Detached,1145,1117,28,0.0244541484716157
170.34,2020,Mobile Home,0,0,0,
170.34,2020,Multifamily,568,521,47,0.0827464788732394
170.34,2020,Single Family - Detached,1145,1106,39,0.034061135371179
170.34,2025,Mobile Home,0,0,0,
170.34,2025,Multifamily,570,531,39,0.068421052631579
170.34,2025,Single Family - Detached,1145,1123,22,0.0192139737991266
170.34,2030,Mobile Home,0,0,0,
170.34,2030,Multifamily,570,531,39,0.068421052631579
170.34,2030,Single Family - Detached,1145,1121,24,0.0209606986899563
170.34,2035,Mobile Home,0,0,0,
170.34,2035,Multifamily,570,533,37,0.0649122807017544
170.34,2035,Single Family - Detached,1145,1127,18,0.0157205240174672
170.34,2040,Mobile Home,0,0,0,
170.34,2040,Multifamily,570,531,39,0.068421052631579
170.34,2040,Single Family - Detached,1145,1117,28,0.0244541484716157
170.34,2045,Mobile Home,0,0,0,
170.34,2045,Multifamily,570,531,39,0.068421052631579
170.34,2045,Single Family - Detached,1149,1111,38,0.0330722367275892
170.34,2050,Mobile Home,0,0,0,
170.34,2050,Multifamily,570,531,39,0.068421052631579
170.34,2050,Single Family - Detached,1167,1127,40,0.0342759211653813
170.35,2012,Mobile Home,0,0,0,
170.35,2012,Multifamily,872,821,51,0.0584862385321101
170.35,2012,Single Family - Detached,365,365,0,0
170.35,2020,Mobile Home,0,0,0,
170.35,2020,Multifamily,872,821,51,0.0584862385321101
170.35,2020,Single Family - Detached,365,365,0,0
170.35,2025,Mobile Home,0,0,0,
170.35,2025,Multifamily,872,824,48,0.055045871559633
170.35,2025,Single Family - Detached,365,365,0,0
170.35,2030,Mobile Home,0,0,0,
170.35,2030,Multifamily,872,824,48,0.055045871559633
170.35,2030,Single Family - Detached,365,365,0,0
170.35,2035,Mobile Home,0,0,0,
170.35,2035,Multifamily,872,825,47,0.0538990825688073
170.35,2035,Single Family - Detached,365,365,0,0
170.35,2040,Mobile Home,0,0,0,
170.35,2040,Multifamily,872,825,47,0.0538990825688073
170.35,2040,Single Family - Detached,365,365,0,0
170.35,2045,Mobile Home,0,0,0,
170.35,2045,Multifamily,872,825,47,0.0538990825688073
170.35,2045,Single Family - Detached,365,365,0,0
170.35,2050,Mobile Home,0,0,0,
170.35,2050,Multifamily,872,825,47,0.0538990825688073
170.35,2050,Single Family - Detached,365,365,0,0
170.36,2012,Mobile Home,0,0,0,
170.36,2012,Multifamily,501,488,13,0.0259481037924152
170.36,2012,Single Family - Detached,722,723,-1,-0.00138504155124654
170.36,2020,Mobile Home,0,0,0,
170.36,2020,Multifamily,501,488,13,0.0259481037924152
170.36,2020,Single Family - Detached,722,722,0,0
170.36,2025,Mobile Home,0,0,0,
170.36,2025,Multifamily,501,496,5,0.00998003992015968
170.36,2025,Single Family - Detached,722,722,0,0
170.36,2030,Mobile Home,0,0,0,
170.36,2030,Multifamily,501,496,5,0.00998003992015968
170.36,2030,Single Family - Detached,722,722,0,0
170.36,2035,Mobile Home,0,0,0,
170.36,2035,Multifamily,501,498,3,0.00598802395209581
170.36,2035,Single Family - Detached,722,722,0,0
170.36,2040,Mobile Home,0,0,0,
170.36,2040,Multifamily,501,495,6,0.0119760479041916
170.36,2040,Single Family - Detached,722,722,0,0
170.36,2045,Mobile Home,0,0,0,
170.36,2045,Multifamily,501,495,6,0.0119760479041916
170.36,2045,Single Family - Detached,722,722,0,0
170.36,2050,Mobile Home,0,0,0,
170.36,2050,Multifamily,501,495,6,0.0119760479041916
170.36,2050,Single Family - Detached,722,722,0,0
170.37,2012,Mobile Home,0,0,0,
170.37,2012,Multifamily,525,525,0,0
170.37,2012,Single Family - Detached,1536,1520,16,0.0104166666666667
170.37,2020,Mobile Home,0,0,0,
170.37,2020,Multifamily,526,526,0,0
170.37,2020,Single Family - Detached,1536,1519,17,0.0110677083333333
170.37,2025,Mobile Home,0,0,0,
170.37,2025,Multifamily,538,538,0,0
170.37,2025,Single Family - Detached,1536,1522,14,0.00911458333333333
170.37,2030,Mobile Home,0,0,0,
170.37,2030,Multifamily,538,538,0,0
170.37,2030,Single Family - Detached,1536,1522,14,0.00911458333333333
170.37,2035,Mobile Home,0,0,0,
170.37,2035,Multifamily,538,538,0,0
170.37,2035,Single Family - Detached,1536,1523,13,0.00846354166666667
170.37,2040,Mobile Home,0,0,0,
170.37,2040,Multifamily,538,537,1,0.00185873605947955
170.37,2040,Single Family - Detached,1536,1520,16,0.0104166666666667
170.37,2045,Mobile Home,0,0,0,
170.37,2045,Multifamily,538,537,1,0.00185873605947955
170.37,2045,Single Family - Detached,1536,1518,18,0.01171875
170.37,2050,Mobile Home,0,0,0,
170.37,2050,Multifamily,538,537,1,0.00185873605947955
170.37,2050,Single Family - Detached,1536,1517,19,0.0123697916666667
170.39,2012,Mobile Home,0,0,0,
170.39,2012,Multifamily,1377,1325,52,0.037763253449528
170.39,2012,Single Family - Detached,1427,1394,33,0.02312543798178
170.39,2020,Mobile Home,0,0,0,
170.39,2020,Multifamily,1377,1329,48,0.0348583877995643
170.39,2020,Single Family - Detached,1427,1392,35,0.0245269796776454
170.39,2025,Mobile Home,0,0,0,
170.39,2025,Multifamily,1377,1331,46,0.0334059549745824
170.39,2025,Single Family - Detached,1427,1394,33,0.02312543798178
170.39,2030,Mobile Home,0,0,0,
170.39,2030,Multifamily,1377,1331,46,0.0334059549745824
170.39,2030,Single Family - Detached,1427,1394,33,0.02312543798178
170.39,2035,Mobile Home,0,0,0,
170.39,2035,Multifamily,1377,1332,45,0.0326797385620915
170.39,2035,Single Family - Detached,1427,1396,31,0.0217238962859145
170.39,2040,Mobile Home,0,0,0,
170.39,2040,Multifamily,1377,1328,49,0.0355846042120552
170.39,2040,Single Family - Detached,1427,1393,34,0.0238262088297127
170.39,2045,Mobile Home,0,0,0,
170.39,2045,Multifamily,1377,1327,50,0.0363108206245461
170.39,2045,Single Family - Detached,1427,1391,36,0.0252277505255781
170.39,2050,Mobile Home,0,0,0,
170.39,2050,Multifamily,1377,1326,51,0.037037037037037
170.39,2050,Single Family - Detached,1427,1391,36,0.0252277505255781
170.40,2012,Mobile Home,0,0,0,
170.40,2012,Multifamily,88,88,0,0
170.40,2012,Single Family - Detached,1346,1310,36,0.0267459138187221
170.40,2020,Mobile Home,0,0,0,
170.40,2020,Multifamily,88,88,0,0
170.40,2020,Single Family - Detached,1346,1306,40,0.0297176820208024
170.40,2025,Mobile Home,0,0,0,
170.40,2025,Multifamily,88,88,0,0
170.40,2025,Single Family - Detached,1352,1314,38,0.0281065088757396
170.40,2030,Mobile Home,0,0,0,
170.40,2030,Multifamily,88,88,0,0
170.40,2030,Single Family - Detached,1358,1318,40,0.0294550810014728
170.40,2035,Mobile Home,0,0,0,
170.40,2035,Multifamily,88,88,0,0
170.40,2035,Single Family - Detached,1358,1318,40,0.0294550810014728
170.40,2040,Mobile Home,0,0,0,
170.40,2040,Multifamily,88,88,0,0
170.40,2040,Single Family - Detached,1358,1316,42,0.0309278350515464
170.40,2045,Mobile Home,0,0,0,
170.40,2045,Multifamily,88,88,0,0
170.40,2045,Single Family - Detached,1358,1314,44,0.03240058910162
170.40,2050,Mobile Home,0,0,0,
170.40,2050,Multifamily,88,88,0,0
170.40,2050,Single Family - Detached,1358,1313,45,0.0331369661266568
170.41,2012,Mobile Home,0,0,0,
170.41,2012,Multifamily,649,637,12,0.0184899845916795
170.41,2012,Single Family - Detached,1524,1489,35,0.0229658792650919
170.41,2020,Mobile Home,0,0,0,
170.41,2020,Multifamily,649,637,12,0.0184899845916795
170.41,2020,Single Family - Detached,1524,1481,43,0.0282152230971129
170.41,2025,Mobile Home,0,0,0,
170.41,2025,Multifamily,764,751,13,0.0170157068062827
170.41,2025,Single Family - Detached,1524,1489,35,0.0229658792650919
170.41,2030,Mobile Home,0,0,0,
170.41,2030,Multifamily,786,779,7,0.0089058524173028
170.41,2030,Single Family - Detached,1524,1484,40,0.026246719160105
170.41,2035,Mobile Home,0,0,0,
170.41,2035,Multifamily,788,781,7,0.00888324873096447
170.41,2035,Single Family - Detached,1565,1526,39,0.0249201277955272
170.41,2040,Mobile Home,0,0,0,
170.41,2040,Multifamily,788,780,8,0.0101522842639594
170.41,2040,Single Family - Detached,1575,1535,40,0.0253968253968254
170.41,2045,Mobile Home,0,0,0,
170.41,2045,Multifamily,788,779,9,0.0114213197969543
170.41,2045,Single Family - Detached,1579,1538,41,0.025965801139962
170.41,2050,Mobile Home,0,0,0,
170.41,2050,Multifamily,788,779,9,0.0114213197969543
170.41,2050,Single Family - Detached,1588,1549,39,0.0245591939546599
170.42,2012,Mobile Home,40,40,0,0
170.42,2012,Multifamily,1026,989,37,0.0360623781676413
170.42,2012,Single Family - Detached,1654,1632,22,0.0133010882708585
170.42,2020,Mobile Home,40,40,0,0
170.42,2020,Multifamily,1026,981,45,0.043859649122807
170.42,2020,Single Family - Detached,1654,1629,25,0.0151148730350665
170.42,2025,Mobile Home,40,39,1,0.025
170.42,2025,Multifamily,1026,983,43,0.0419103313840156
170.42,2025,Single Family - Detached,1654,1631,23,0.0139056831922612
170.42,2030,Mobile Home,40,37,3,0.075
170.42,2030,Multifamily,1026,982,44,0.0428849902534113
170.42,2030,Single Family - Detached,1659,1652,7,0.00421940928270042
170.42,2035,Mobile Home,40,37,3,0.075
170.42,2035,Multifamily,1026,984,42,0.0409356725146199
170.42,2035,Single Family - Detached,1661,1654,7,0.00421432871763998
170.42,2040,Mobile Home,40,38,2,0.05
170.42,2040,Multifamily,1026,982,44,0.0428849902534113
170.42,2040,Single Family - Detached,1661,1652,9,0.00541842263696568
170.42,2045,Mobile Home,40,37,3,0.075
170.42,2045,Multifamily,1026,981,45,0.043859649122807
170.42,2045,Single Family - Detached,1661,1651,10,0.00602046959662854
170.42,2050,Mobile Home,40,32,8,0.2
170.42,2050,Multifamily,1026,980,46,0.0448343079922027
170.42,2050,Single Family - Detached,1661,1651,10,0.00602046959662854
170.43,2012,Mobile Home,0,0,0,
170.43,2012,Multifamily,961,908,53,0.0551508844953174
170.43,2012,Single Family - Detached,1094,1085,9,0.00822669104204753
170.43,2020,Mobile Home,0,0,0,
170.43,2020,Multifamily,1057,1031,26,0.0245979186376537
170.43,2020,Single Family - Detached,1094,1084,10,0.00914076782449726
170.43,2025,Mobile Home,0,0,0,
170.43,2025,Multifamily,1091,1070,21,0.0192483959670028
170.43,2025,Single Family - Detached,1094,1086,8,0.00731261425959781
170.43,2030,Mobile Home,0,0,0,
170.43,2030,Multifamily,1119,1098,21,0.0187667560321716
170.43,2030,Single Family - Detached,1094,1086,8,0.00731261425959781
170.43,2035,Mobile Home,0,0,0,
170.43,2035,Multifamily,1119,1098,21,0.0187667560321716
170.43,2035,Single Family - Detached,1094,1088,6,0.00548446069469835
170.43,2040,Mobile Home,0,0,0,
170.43,2040,Multifamily,1119,1096,23,0.0205540661304736
170.43,2040,Single Family - Detached,1094,1086,8,0.00731261425959781
170.43,2045,Mobile Home,0,0,0,
170.43,2045,Multifamily,1119,1096,23,0.0205540661304736
170.43,2045,Single Family - Detached,1094,1085,9,0.00822669104204753
170.43,2050,Mobile Home,0,0,0,
170.43,2050,Multifamily,1119,1096,23,0.0205540661304736
170.43,2050,Single Family - Detached,1094,1085,9,0.00822669104204753
170.44,2012,Mobile Home,0,0,0,
170.44,2012,Multifamily,636,609,27,0.0424528301886792
170.44,2012,Single Family - Detached,1248,1248,0,0
170.44,2020,Mobile Home,0,0,0,
170.44,2020,Multifamily,636,594,42,0.0660377358490566
170.44,2020,Single Family - Detached,1249,1247,2,0.00160128102481986
170.44,2025,Mobile Home,0,0,0,
170.44,2025,Multifamily,636,597,39,0.0613207547169811
170.44,2025,Single Family - Detached,1270,1270,0,0
170.44,2030,Mobile Home,0,0,0,
170.44,2030,Multifamily,636,596,40,0.0628930817610063
170.44,2030,Single Family - Detached,1290,1289,1,0.000775193798449612
170.44,2035,Mobile Home,0,0,0,
170.44,2035,Multifamily,636,597,39,0.0613207547169811
170.44,2035,Single Family - Detached,1293,1293,0,0
170.44,2040,Mobile Home,0,0,0,
170.44,2040,Multifamily,636,596,40,0.0628930817610063
170.44,2040,Single Family - Detached,1293,1290,3,0.00232018561484919
170.44,2045,Mobile Home,0,0,0,
170.44,2045,Multifamily,636,596,40,0.0628930817610063
170.44,2045,Single Family - Detached,1293,1287,6,0.00464037122969838
170.44,2050,Mobile Home,0,0,0,
170.44,2050,Multifamily,636,596,40,0.0628930817610063
170.44,2050,Single Family - Detached,1293,1286,7,0.00541376643464811
170.45,2012,Mobile Home,0,0,0,
170.45,2012,Multifamily,0,0,0,
170.45,2012,Single Family - Detached,867,856,11,0.0126874279123414
170.45,2020,Mobile Home,0,0,0,
170.45,2020,Multifamily,0,0,0,
170.45,2020,Single Family - Detached,867,854,13,0.0149942329873126
170.45,2025,Mobile Home,0,0,0,
170.45,2025,Multifamily,0,0,0,
170.45,2025,Single Family - Detached,867,857,10,0.0115340253748558
170.45,2030,Mobile Home,0,0,0,
170.45,2030,Multifamily,0,0,0,
170.45,2030,Single Family - Detached,867,857,10,0.0115340253748558
170.45,2035,Mobile Home,0,0,0,
170.45,2035,Multifamily,0,0,0,
170.45,2035,Single Family - Detached,871,862,9,0.0103329506314581
170.45,2040,Mobile Home,0,0,0,
170.45,2040,Multifamily,0,0,0,
170.45,2040,Single Family - Detached,892,881,11,0.0123318385650224
170.45,2045,Mobile Home,0,0,0,
170.45,2045,Multifamily,0,0,0,
170.45,2045,Single Family - Detached,902,889,13,0.0144124168514412
170.45,2050,Mobile Home,0,0,0,
170.45,2050,Multifamily,0,0,0,
170.45,2050,Single Family - Detached,920,907,13,0.0141304347826087
170.46,2012,Mobile Home,0,0,0,
170.46,2012,Multifamily,128,120,8,0.0625
170.46,2012,Single Family - Detached,1291,1285,6,0.00464756003098373
170.46,2020,Mobile Home,0,0,0,
170.46,2020,Multifamily,128,115,13,0.1015625
170.46,2020,Single Family - Detached,1291,1285,6,0.00464756003098373
170.46,2025,Mobile Home,0,0,0,
170.46,2025,Multifamily,128,116,12,0.09375
170.46,2025,Single Family - Detached,1291,1288,3,0.00232378001549187
170.46,2030,Mobile Home,0,0,0,
170.46,2030,Multifamily,128,115,13,0.1015625
170.46,2030,Single Family - Detached,1292,1289,3,0.00232198142414861
170.46,2035,Mobile Home,0,0,0,
170.46,2035,Multifamily,128,116,12,0.09375
170.46,2035,Single Family - Detached,1292,1289,3,0.00232198142414861
170.46,2040,Mobile Home,0,0,0,
170.46,2040,Multifamily,128,114,14,0.109375
170.46,2040,Single Family - Detached,1292,1289,3,0.00232198142414861
170.46,2045,Mobile Home,0,0,0,
170.46,2045,Multifamily,128,112,16,0.125
170.46,2045,Single Family - Detached,1292,1289,3,0.00232198142414861
170.46,2050,Mobile Home,0,0,0,
170.46,2050,Multifamily,128,110,18,0.140625
170.46,2050,Single Family - Detached,1292,1289,3,0.00232198142414861
170.47,2012,Mobile Home,0,0,0,
170.47,2012,Multifamily,0,0,0,
170.47,2012,Single Family - Detached,1414,1398,16,0.0113154172560113
170.47,2020,Mobile Home,0,0,0,
170.47,2020,Multifamily,0,0,0,
170.47,2020,Single Family - Detached,1414,1397,17,0.012022630834512
170.47,2025,Mobile Home,0,0,0,
170.47,2025,Multifamily,0,0,0,
170.47,2025,Single Family - Detached,1414,1401,13,0.00919377652050919
170.47,2030,Mobile Home,0,0,0,
170.47,2030,Multifamily,0,0,0,
170.47,2030,Single Family - Detached,1414,1401,13,0.00919377652050919
170.47,2035,Mobile Home,0,0,0,
170.47,2035,Multifamily,0,0,0,
170.47,2035,Single Family - Detached,1414,1402,12,0.00848656294200849
170.47,2040,Mobile Home,0,0,0,
170.47,2040,Multifamily,0,0,0,
170.47,2040,Single Family - Detached,1414,1401,13,0.00919377652050919
170.47,2045,Mobile Home,0,0,0,
170.47,2045,Multifamily,0,0,0,
170.47,2045,Single Family - Detached,1414,1400,14,0.0099009900990099
170.47,2050,Mobile Home,0,0,0,
170.47,2050,Multifamily,0,0,0,
170.47,2050,Single Family - Detached,1414,1399,15,0.0106082036775106
170.48,2012,Mobile Home,400,395,5,0.0125
170.48,2012,Multifamily,935,897,38,0.0406417112299465
170.48,2012,Single Family - Detached,862,843,19,0.0220417633410673
170.48,2020,Mobile Home,400,397,3,0.0075
170.48,2020,Multifamily,936,898,38,0.0405982905982906
170.48,2020,Single Family - Detached,862,837,25,0.0290023201856148
170.48,2025,Mobile Home,400,397,3,0.0075
170.48,2025,Multifamily,1104,1069,35,0.0317028985507246
170.48,2025,Single Family - Detached,877,856,21,0.023945267958951
170.48,2030,Mobile Home,400,396,4,0.01
170.48,2030,Multifamily,1169,1131,38,0.0325064157399487
170.48,2030,Single Family - Detached,901,876,25,0.0277469478357381
170.48,2035,Mobile Home,400,396,4,0.01
170.48,2035,Multifamily,1216,1177,39,0.0320723684210526
170.48,2035,Single Family - Detached,907,886,21,0.0231532524807056
170.48,2040,Mobile Home,400,396,4,0.01
170.48,2040,Multifamily,1226,1186,40,0.032626427406199
170.48,2040,Single Family - Detached,907,883,24,0.0264608599779493
170.48,2045,Mobile Home,400,395,5,0.0125
170.48,2045,Multifamily,1263,1221,42,0.0332541567695962
170.48,2045,Single Family - Detached,907,881,26,0.0286659316427784
170.48,2050,Mobile Home,400,391,9,0.0225
170.48,2050,Multifamily,1263,1221,42,0.0332541567695962
170.48,2050,Single Family - Detached,907,879,28,0.0308710033076075
170.49,2012,Mobile Home,0,0,0,
170.49,2012,Multifamily,73,71,2,0.0273972602739726
170.49,2012,Single Family - Detached,870,869,1,0.00114942528735632
170.49,2020,Mobile Home,0,0,0,
170.49,2020,Multifamily,73,73,0,0
170.49,2020,Single Family - Detached,874,864,10,0.011441647597254
170.49,2025,Mobile Home,0,0,0,
170.49,2025,Multifamily,73,73,0,0
170.49,2025,Single Family - Detached,873,868,5,0.00572737686139748
170.49,2030,Mobile Home,0,0,0,
170.49,2030,Multifamily,73,71,2,0.0273972602739726
170.49,2030,Single Family - Detached,873,864,9,0.0103092783505155
170.49,2035,Mobile Home,0,0,0,
170.49,2035,Multifamily,73,73,0,0
170.49,2035,Single Family - Detached,906,901,5,0.00551876379690949
170.49,2040,Mobile Home,0,0,0,
170.49,2040,Multifamily,73,71,2,0.0273972602739726
170.49,2040,Single Family - Detached,915,906,9,0.00983606557377049
170.49,2045,Mobile Home,0,0,0,
170.49,2045,Multifamily,75,73,2,0.0266666666666667
170.49,2045,Single Family - Detached,919,905,14,0.015233949945593
170.49,2050,Mobile Home,0,0,0,
170.49,2050,Multifamily,75,73,2,0.0266666666666667
170.49,2050,Single Family - Detached,935,919,16,0.0171122994652406
170.50,2012,Mobile Home,0,0,0,
170.50,2012,Multifamily,268,267,1,0.00373134328358209
170.50,2012,Single Family - Detached,794,764,30,0.0377833753148615
170.50,2020,Mobile Home,0,0,0,
170.50,2020,Multifamily,268,268,0,0
170.50,2020,Single Family - Detached,795,778,17,0.0213836477987421
170.50,2025,Mobile Home,0,0,0,
170.50,2025,Multifamily,268,268,0,0
170.50,2025,Single Family - Detached,821,817,4,0.0048721071863581
170.50,2030,Mobile Home,0,0,0,
170.50,2030,Multifamily,268,266,2,0.00746268656716418
170.50,2030,Single Family - Detached,837,828,9,0.010752688172043
170.50,2035,Mobile Home,0,0,0,
170.50,2035,Multifamily,268,267,1,0.00373134328358209
170.50,2035,Single Family - Detached,842,834,8,0.00950118764845606
170.50,2040,Mobile Home,0,0,0,
170.50,2040,Multifamily,268,265,3,0.0111940298507463
170.50,2040,Single Family - Detached,842,830,12,0.0142517814726841
170.50,2045,Mobile Home,0,0,0,
170.50,2045,Multifamily,268,264,4,0.0149253731343284
170.50,2045,Single Family - Detached,842,824,18,0.0213776722090261
170.50,2050,Mobile Home,0,0,0,
170.50,2050,Multifamily,268,264,4,0.0149253731343284
170.50,2050,Single Family - Detached,842,822,20,0.0237529691211401
170.51,2012,Mobile Home,0,0,0,
170.51,2012,Multifamily,732,732,0,0
170.51,2012,Single Family - Detached,1402,1293,109,0.0777460770328103
170.51,2020,Mobile Home,0,0,0,
170.51,2020,Multifamily,733,733,0,0
170.51,2020,Single Family - Detached,1403,1289,114,0.0812544547398432
170.51,2025,Mobile Home,0,0,0,
170.51,2025,Multifamily,734,732,2,0.00272479564032698
170.51,2025,Single Family - Detached,1403,1290,113,0.0805416963649323
170.51,2030,Mobile Home,0,0,0,
170.51,2030,Multifamily,734,732,2,0.00272479564032698
170.51,2030,Single Family - Detached,1403,1290,113,0.0805416963649323
170.51,2035,Mobile Home,0,0,0,
170.51,2035,Multifamily,734,732,2,0.00272479564032698
170.51,2035,Single Family - Detached,1403,1291,112,0.0798289379900214
170.51,2040,Mobile Home,0,0,0,
170.51,2040,Multifamily,734,731,3,0.00408719346049046
170.51,2040,Single Family - Detached,1403,1289,114,0.0812544547398432
170.51,2045,Mobile Home,0,0,0,
170.51,2045,Multifamily,734,731,3,0.00408719346049046
170.51,2045,Single Family - Detached,1403,1288,115,0.0819672131147541
170.51,2050,Mobile Home,0,0,0,
170.51,2050,Multifamily,734,731,3,0.00408719346049046
170.51,2050,Single Family - Detached,1403,1288,115,0.0819672131147541
170.52,2012,Mobile Home,0,0,0,
170.52,2012,Multifamily,1090,1024,66,0.0605504587155963
170.52,2012,Single Family - Detached,1191,1111,80,0.0671704450041982
170.52,2020,Mobile Home,0,0,0,
170.52,2020,Multifamily,1090,1024,66,0.0605504587155963
170.52,2020,Single Family - Detached,1191,1107,84,0.0705289672544081
170.52,2025,Mobile Home,0,0,0,
170.52,2025,Multifamily,1090,1015,75,0.0688073394495413
170.52,2025,Single Family - Detached,1191,1108,83,0.0696893366918556
170.52,2030,Mobile Home,0,0,0,
170.52,2030,Multifamily,1090,1015,75,0.0688073394495413
170.52,2030,Single Family - Detached,1191,1108,83,0.0696893366918556
170.52,2035,Mobile Home,0,0,0,
170.52,2035,Multifamily,1090,1015,75,0.0688073394495413
170.52,2035,Single Family - Detached,1191,1108,83,0.0696893366918556
170.52,2040,Mobile Home,0,0,0,
170.52,2040,Multifamily,1090,1012,78,0.0715596330275229
170.52,2040,Single Family - Detached,1191,1107,84,0.0705289672544081
170.52,2045,Mobile Home,0,0,0,
170.52,2045,Multifamily,1090,1011,79,0.0724770642201835
170.52,2045,Single Family - Detached,1191,1107,84,0.0705289672544081
170.52,2050,Mobile Home,0,0,0,
170.52,2050,Multifamily,1090,1010,80,0.073394495412844
170.52,2050,Single Family - Detached,1191,1107,84,0.0705289672544081
170.53,2012,Mobile Home,0,0,0,
170.53,2012,Multifamily,0,0,0,
170.53,2012,Single Family - Detached,1131,1111,20,0.017683465959328
170.53,2020,Mobile Home,0,0,0,
170.53,2020,Multifamily,0,0,0,
170.53,2020,Single Family - Detached,1131,1111,20,0.017683465959328
170.53,2025,Mobile Home,0,0,0,
170.53,2025,Multifamily,0,0,0,
170.53,2025,Single Family - Detached,1131,1114,17,0.0150309460654288
170.53,2030,Mobile Home,0,0,0,
170.53,2030,Multifamily,0,0,0,
170.53,2030,Single Family - Detached,1131,1114,17,0.0150309460654288
170.53,2035,Mobile Home,0,0,0,
170.53,2035,Multifamily,0,0,0,
170.53,2035,Single Family - Detached,1155,1143,12,0.0103896103896104
170.53,2040,Mobile Home,0,0,0,
170.53,2040,Multifamily,0,0,0,
170.53,2040,Single Family - Detached,1155,1143,12,0.0103896103896104
170.53,2045,Mobile Home,0,0,0,
170.53,2045,Multifamily,0,0,0,
170.53,2045,Single Family - Detached,1155,1143,12,0.0103896103896104
170.53,2050,Mobile Home,0,0,0,
170.53,2050,Multifamily,0,0,0,
170.53,2050,Single Family - Detached,1155,1143,12,0.0103896103896104
170.54,2012,Mobile Home,0,0,0,
170.54,2012,Multifamily,347,344,3,0.00864553314121038
170.54,2012,Single Family - Detached,1666,1647,19,0.0114045618247299
170.54,2020,Mobile Home,0,0,0,
170.54,2020,Multifamily,348,348,0,0
170.54,2020,Single Family - Detached,1667,1639,28,0.0167966406718656
170.54,2025,Mobile Home,0,0,0,
170.54,2025,Multifamily,376,375,1,0.00265957446808511
170.54,2025,Single Family - Detached,1683,1667,16,0.0095068330362448
170.54,2030,Mobile Home,0,0,0,
170.54,2030,Multifamily,376,375,1,0.00265957446808511
170.54,2030,Single Family - Detached,1696,1679,17,0.0100235849056604
170.54,2035,Mobile Home,0,0,0,
170.54,2035,Multifamily,376,376,0,0
170.54,2035,Single Family - Detached,1722,1694,28,0.016260162601626
170.54,2040,Mobile Home,0,0,0,
170.54,2040,Multifamily,376,375,1,0.00265957446808511
170.54,2040,Single Family - Detached,1722,1690,32,0.0185830429732869
170.54,2045,Mobile Home,0,0,0,
170.54,2045,Multifamily,376,375,1,0.00265957446808511
170.54,2045,Single Family - Detached,1722,1687,35,0.0203252032520325
170.54,2050,Mobile Home,0,0,0,
170.54,2050,Multifamily,376,375,1,0.00265957446808511
170.54,2050,Single Family - Detached,1722,1687,35,0.0203252032520325
170.55,2012,Mobile Home,0,0,0,
170.55,2012,Multifamily,397,397,0,0
170.55,2012,Single Family - Detached,1561,1492,69,0.0442024343369635
170.55,2020,Mobile Home,0,0,0,
170.55,2020,Multifamily,397,397,0,0
170.55,2020,Single Family - Detached,1561,1492,69,0.0442024343369635
170.55,2025,Mobile Home,0,0,0,
170.55,2025,Multifamily,397,397,0,0
170.55,2025,Single Family - Detached,1561,1494,67,0.0429212043561819
170.55,2030,Mobile Home,0,0,0,
170.55,2030,Multifamily,397,397,0,0
170.55,2030,Single Family - Detached,1561,1494,67,0.0429212043561819
170.55,2035,Mobile Home,0,0,0,
170.55,2035,Multifamily,397,397,0,0
170.55,2035,Single Family - Detached,1561,1495,66,0.0422805893657912
170.55,2040,Mobile Home,0,0,0,
170.55,2040,Multifamily,397,396,1,0.00251889168765743
170.55,2040,Single Family - Detached,1561,1494,67,0.0429212043561819
170.55,2045,Mobile Home,0,0,0,
170.55,2045,Multifamily,397,396,1,0.00251889168765743
170.55,2045,Single Family - Detached,1561,1494,67,0.0429212043561819
170.55,2050,Mobile Home,0,0,0,
170.55,2050,Multifamily,397,396,1,0.00251889168765743
170.55,2050,Single Family - Detached,1561,1494,67,0.0429212043561819
170.56,2012,Mobile Home,0,0,0,
170.56,2012,Multifamily,1150,1146,4,0.00347826086956522
170.56,2012,Single Family - Detached,694,658,36,0.0518731988472622
170.56,2020,Mobile Home,0,0,0,
170.56,2020,Multifamily,1150,1150,0,0
170.56,2020,Single Family - Detached,694,657,37,0.053314121037464
170.56,2025,Mobile Home,0,0,0,
170.56,2025,Multifamily,1150,1150,0,0
170.56,2025,Single Family - Detached,694,657,37,0.053314121037464
170.56,2030,Mobile Home,0,0,0,
170.56,2030,Multifamily,1150,1150,0,0
170.56,2030,Single Family - Detached,694,657,37,0.053314121037464
170.56,2035,Mobile Home,0,0,0,
170.56,2035,Multifamily,1150,1150,0,0
170.56,2035,Single Family - Detached,694,657,37,0.053314121037464
170.56,2040,Mobile Home,0,0,0,
170.56,2040,Multifamily,1150,1148,2,0.00173913043478261
170.56,2040,Single Family - Detached,694,656,38,0.0547550432276657
170.56,2045,Mobile Home,0,0,0,
170.56,2045,Multifamily,1150,1147,3,0.00260869565217391
170.56,2045,Single Family - Detached,694,655,39,0.0561959654178674
170.56,2050,Mobile Home,0,0,0,
170.56,2050,Multifamily,1150,1146,4,0.00347826086956522
170.56,2050,Single Family - Detached,694,655,39,0.0561959654178674
171.04,2012,Mobile Home,0,0,0,
171.04,2012,Multifamily,116,115,1,0.00862068965517241
171.04,2012,Single Family - Detached,1371,1359,12,0.0087527352297593
171.04,2020,Mobile Home,0,0,0,
171.04,2020,Multifamily,124,124,0,0
171.04,2020,Single Family - Detached,1390,1385,5,0.00359712230215827
171.04,2025,Mobile Home,0,0,0,
171.04,2025,Multifamily,124,124,0,0
171.04,2025,Single Family - Detached,1390,1386,4,0.00287769784172662
171.04,2030,Mobile Home,0,0,0,
171.04,2030,Multifamily,124,124,0,0
171.04,2030,Single Family - Detached,1392,1388,4,0.0028735632183908
171.04,2035,Mobile Home,0,0,0,
171.04,2035,Multifamily,124,124,0,0
171.04,2035,Single Family - Detached,1396,1392,4,0.00286532951289398
171.04,2040,Mobile Home,0,0,0,
171.04,2040,Multifamily,124,124,0,0
171.04,2040,Single Family - Detached,1396,1392,4,0.00286532951289398
171.04,2045,Mobile Home,0,0,0,
171.04,2045,Multifamily,124,124,0,0
171.04,2045,Single Family - Detached,1396,1392,4,0.00286532951289398
171.04,2050,Mobile Home,0,0,0,
171.04,2050,Multifamily,124,124,0,0
171.04,2050,Single Family - Detached,1396,1389,7,0.00501432664756447
171.06,2012,Mobile Home,0,0,0,
171.06,2012,Multifamily,85,59,26,0.305882352941176
171.06,2012,Single Family - Detached,2126,1951,175,0.0823142050799624
171.06,2020,Mobile Home,0,0,0,
171.06,2020,Multifamily,85,70,15,0.176470588235294
171.06,2020,Single Family - Detached,2229,2035,194,0.0870345446388515
171.06,2025,Mobile Home,0,0,0,
171.06,2025,Multifamily,85,72,13,0.152941176470588
171.06,2025,Single Family - Detached,2244,2084,160,0.071301247771836
171.06,2030,Mobile Home,0,0,0,
171.06,2030,Multifamily,85,72,13,0.152941176470588
171.06,2030,Single Family - Detached,2264,2100,164,0.0724381625441696
171.06,2035,Mobile Home,0,0,0,
171.06,2035,Multifamily,85,74,11,0.129411764705882
171.06,2035,Single Family - Detached,2285,2134,151,0.0660831509846827
171.06,2040,Mobile Home,0,0,0,
171.06,2040,Multifamily,85,73,12,0.141176470588235
171.06,2040,Single Family - Detached,2285,2131,154,0.0673960612691466
171.06,2045,Mobile Home,0,0,0,
171.06,2045,Multifamily,86,73,13,0.151162790697674
171.06,2045,Single Family - Detached,2285,2128,157,0.0687089715536105
171.06,2050,Mobile Home,0,0,0,
171.06,2050,Multifamily,86,73,13,0.151162790697674
171.06,2050,Single Family - Detached,2285,2127,158,0.0691466083150985
171.07,2012,Mobile Home,0,0,0,
171.07,2012,Multifamily,0,0,0,
171.07,2012,Single Family - Detached,1008,998,10,0.00992063492063492
171.07,2020,Mobile Home,0,0,0,
171.07,2020,Multifamily,0,0,0,
171.07,2020,Single Family - Detached,1021,1008,13,0.0127326150832517
171.07,2025,Mobile Home,0,0,0,
171.07,2025,Multifamily,0,0,0,
171.07,2025,Single Family - Detached,1021,1012,9,0.00881488736532811
171.07,2030,Mobile Home,0,0,0,
171.07,2030,Multifamily,0,0,0,
171.07,2030,Single Family - Detached,1021,1012,9,0.00881488736532811
171.07,2035,Mobile Home,0,0,0,
171.07,2035,Multifamily,0,0,0,
171.07,2035,Single Family - Detached,1021,1014,7,0.00685602350636631
171.07,2040,Mobile Home,0,0,0,
171.07,2040,Multifamily,0,0,0,
171.07,2040,Single Family - Detached,1021,1013,8,0.00783545543584721
171.07,2045,Mobile Home,0,0,0,
171.07,2045,Multifamily,0,0,0,
171.07,2045,Single Family - Detached,1021,1011,10,0.00979431929480901
171.07,2050,Mobile Home,0,0,0,
171.07,2050,Multifamily,0,0,0,
171.07,2050,Single Family - Detached,1021,1010,11,0.0107737512242899
171.08,2012,Mobile Home,0,0,0,
171.08,2012,Multifamily,0,0,0,
171.08,2012,Single Family - Detached,1705,1687,18,0.0105571847507331
171.08,2020,Mobile Home,0,0,0,
171.08,2020,Multifamily,0,0,0,
171.08,2020,Single Family - Detached,1705,1687,18,0.0105571847507331
171.08,2025,Mobile Home,0,0,0,
171.08,2025,Multifamily,0,0,0,
171.08,2025,Single Family - Detached,1705,1691,14,0.00821114369501466
171.08,2030,Mobile Home,0,0,0,
171.08,2030,Multifamily,0,0,0,
171.08,2030,Single Family - Detached,1705,1691,14,0.00821114369501466
171.08,2035,Mobile Home,0,0,0,
171.08,2035,Multifamily,0,0,0,
171.08,2035,Single Family - Detached,1705,1694,11,0.00645161290322581
171.08,2040,Mobile Home,0,0,0,
171.08,2040,Multifamily,0,0,0,
171.08,2040,Single Family - Detached,1705,1693,12,0.00703812316715543
171.08,2045,Mobile Home,0,0,0,
171.08,2045,Multifamily,0,0,0,
171.08,2045,Single Family - Detached,1705,1693,12,0.00703812316715543
171.08,2050,Mobile Home,0,0,0,
171.08,2050,Multifamily,0,0,0,
171.08,2050,Single Family - Detached,1705,1693,12,0.00703812316715543
171.09,2012,Mobile Home,0,0,0,
171.09,2012,Multifamily,496,496,0,0
171.09,2012,Single Family - Detached,1758,1670,88,0.0500568828213879
171.09,2020,Mobile Home,0,0,0,
171.09,2020,Multifamily,496,494,2,0.00403225806451613
171.09,2020,Single Family - Detached,1854,1749,105,0.0566343042071197
171.09,2025,Mobile Home,0,0,0,
171.09,2025,Multifamily,496,495,1,0.00201612903225806
171.09,2025,Single Family - Detached,1854,1765,89,0.0480043149946063
171.09,2030,Mobile Home,0,0,0,
171.09,2030,Multifamily,496,495,1,0.00201612903225806
171.09,2030,Single Family - Detached,1854,1764,90,0.0485436893203883
171.09,2035,Mobile Home,0,0,0,
171.09,2035,Multifamily,496,495,1,0.00201612903225806
171.09,2035,Single Family - Detached,1854,1768,86,0.04638619201726
171.09,2040,Mobile Home,0,0,0,
171.09,2040,Multifamily,496,495,1,0.00201612903225806
171.09,2040,Single Family - Detached,1854,1768,86,0.04638619201726
171.09,2045,Mobile Home,0,0,0,
171.09,2045,Multifamily,496,495,1,0.00201612903225806
171.09,2045,Single Family - Detached,1854,1767,87,0.0469255663430421
171.09,2050,Mobile Home,0,0,0,
171.09,2050,Multifamily,496,495,1,0.00201612903225806
171.09,2050,Single Family - Detached,1854,1766,88,0.0474649406688242
171.10,2012,Mobile Home,0,0,0,
171.10,2012,Multifamily,799,765,34,0.0425531914893617
171.10,2012,Single Family - Detached,3146,2907,239,0.0759694850603942
171.10,2020,Mobile Home,0,0,0,
171.10,2020,Multifamily,963,914,49,0.0508826583592939
171.10,2020,Single Family - Detached,3533,3222,311,0.0880271723747523
171.10,2025,Mobile Home,0,0,0,
171.10,2025,Multifamily,963,919,44,0.0456905503634476
171.10,2025,Single Family - Detached,3661,3390,271,0.0740234908494947
171.10,2030,Mobile Home,0,0,0,
171.10,2030,Multifamily,963,918,45,0.0467289719626168
171.10,2030,Single Family - Detached,3796,3497,299,0.0787671232876712
171.10,2035,Mobile Home,0,0,0,
171.10,2035,Multifamily,963,920,43,0.0446521287642783
171.10,2035,Single Family - Detached,3968,3668,300,0.0756048387096774
171.10,2040,Mobile Home,0,0,0,
171.10,2040,Multifamily,963,928,35,0.0363447559709242
171.10,2040,Single Family - Detached,4007,3683,324,0.080858497629149
171.10,2045,Mobile Home,0,0,0,
171.10,2045,Multifamily,963,927,36,0.0373831775700935
171.10,2045,Single Family - Detached,4034,3680,354,0.0877540902330193
171.10,2050,Mobile Home,0,0,0,
171.10,2050,Multifamily,963,926,37,0.0384215991692627
171.10,2050,Single Family - Detached,4051,3689,362,0.0893606516909405
172,2012,Mobile Home,0,0,0,
172,2012,Multifamily,730,622,108,0.147945205479452
172,2012,Single Family - Detached,1907,1444,463,0.24278972207656
172,2020,Mobile Home,0,0,0,
172,2020,Multifamily,730,628,102,0.13972602739726
172,2020,Single Family - Detached,1916,1474,442,0.230688935281837
172,2025,Mobile Home,0,0,0,
172,2025,Multifamily,724,636,88,0.121546961325967
172,2025,Single Family - Detached,1918,1554,364,0.18978102189781
172,2030,Mobile Home,0,0,0,
172,2030,Multifamily,727,638,89,0.12242090784044
172,2030,Single Family - Detached,1916,1544,372,0.194154488517745
172,2035,Mobile Home,0,0,0,
172,2035,Multifamily,728,643,85,0.116758241758242
172,2035,Single Family - Detached,1925,1576,349,0.181298701298701
172,2040,Mobile Home,0,0,0,
172,2040,Multifamily,739,649,90,0.121786197564276
172,2040,Single Family - Detached,1921,1631,290,0.15096304008329
172,2045,Mobile Home,0,0,0,
172,2045,Multifamily,741,646,95,0.128205128205128
172,2045,Single Family - Detached,1924,1609,315,0.163721413721414
172,2050,Mobile Home,0,0,0,
172,2050,Multifamily,749,651,98,0.130841121495327
172,2050,Single Family - Detached,1925,1600,325,0.168831168831169
173.03,2012,Mobile Home,0,0,0,
173.03,2012,Multifamily,146,137,9,0.0616438356164384
173.03,2012,Single Family - Detached,1174,1096,78,0.0664395229982964
173.03,2020,Mobile Home,0,0,0,
173.03,2020,Multifamily,146,132,14,0.0958904109589041
173.03,2020,Single Family - Detached,1183,1094,89,0.0752324598478445
173.03,2025,Mobile Home,0,0,0,
173.03,2025,Multifamily,146,138,8,0.0547945205479452
173.03,2025,Single Family - Detached,1180,1092,88,0.0745762711864407
173.03,2030,Mobile Home,0,0,0,
173.03,2030,Multifamily,170,149,21,0.123529411764706
173.03,2030,Single Family - Detached,1170,1083,87,0.0743589743589744
173.03,2035,Mobile Home,0,0,0,
173.03,2035,Multifamily,218,190,28,0.128440366972477
173.03,2035,Single Family - Detached,1173,1084,89,0.0758738277919864
173.03,2040,Mobile Home,0,0,0,
173.03,2040,Multifamily,295,274,21,0.0711864406779661
173.03,2040,Single Family - Detached,1173,1084,89,0.0758738277919864
173.03,2045,Mobile Home,0,0,0,
173.03,2045,Multifamily,301,274,27,0.0897009966777409
173.03,2045,Single Family - Detached,1164,1073,91,0.0781786941580756
173.03,2050,Mobile Home,0,0,0,
173.03,2050,Multifamily,301,270,31,0.102990033222591
173.03,2050,Single Family - Detached,1164,1073,91,0.0781786941580756
173.04,2012,Mobile Home,26,16,10,0.384615384615385
173.04,2012,Multifamily,2197,1617,580,0.263996358670915
173.04,2012,Single Family - Detached,956,893,63,0.0658995815899582
173.04,2020,Mobile Home,0,0,0,
173.04,2020,Multifamily,2285,1665,620,0.271334792122538
173.04,2020,Single Family - Detached,946,881,65,0.0687103594080338
173.04,2025,Mobile Home,0,0,0,
173.04,2025,Multifamily,2338,1771,567,0.24251497005988
173.04,2025,Single Family - Detached,949,888,61,0.0642781875658588
173.04,2030,Mobile Home,0,0,0,
173.04,2030,Multifamily,2439,1848,591,0.242312423124231
173.04,2030,Single Family - Detached,952,886,66,0.069327731092437
173.04,2035,Mobile Home,0,0,0,
173.04,2035,Multifamily,2437,1868,569,0.233483791546984
173.04,2035,Single Family - Detached,969,915,54,0.0557275541795666
173.04,2040,Mobile Home,0,0,0,
173.04,2040,Multifamily,2520,2029,491,0.19484126984127
173.04,2040,Single Family - Detached,969,911,58,0.0598555211558308
173.04,2045,Mobile Home,0,0,0,
173.04,2045,Multifamily,2628,2095,533,0.202815829528158
173.04,2045,Single Family - Detached,969,899,70,0.0722394220846233
173.04,2050,Mobile Home,0,0,0,
173.04,2050,Multifamily,2651,2106,545,0.205582798943795
173.04,2050,Single Family - Detached,969,898,71,0.0732714138286894
173.05,2012,Mobile Home,0,0,0,
173.05,2012,Multifamily,220,188,32,0.145454545454545
173.05,2012,Single Family - Detached,1139,1101,38,0.0333625987708516
173.05,2020,Mobile Home,0,0,0,
173.05,2020,Multifamily,220,194,26,0.118181818181818
173.05,2020,Single Family - Detached,1143,1103,40,0.0349956255468067
173.05,2025,Mobile Home,0,0,0,
173.05,2025,Multifamily,220,195,25,0.113636363636364
173.05,2025,Single Family - Detached,1143,1112,31,0.0271216097987752
173.05,2030,Mobile Home,0,0,0,
173.05,2030,Multifamily,220,195,25,0.113636363636364
173.05,2030,Single Family - Detached,1143,1111,32,0.0279965004374453
173.05,2035,Mobile Home,0,0,0,
173.05,2035,Multifamily,220,196,24,0.109090909090909
173.05,2035,Single Family - Detached,1143,1114,29,0.0253718285214348
173.05,2040,Mobile Home,0,0,0,
173.05,2040,Multifamily,220,196,24,0.109090909090909
173.05,2040,Single Family - Detached,1143,1114,29,0.0253718285214348
173.05,2045,Mobile Home,0,0,0,
173.05,2045,Multifamily,220,196,24,0.109090909090909
173.05,2045,Single Family - Detached,1143,1114,29,0.0253718285214348
173.05,2050,Mobile Home,0,0,0,
173.05,2050,Multifamily,220,196,24,0.109090909090909
173.05,2050,Single Family - Detached,1143,1114,29,0.0253718285214348
173.06,2012,Mobile Home,0,0,0,
173.06,2012,Multifamily,151,149,2,0.0132450331125828
173.06,2012,Single Family - Detached,1128,1063,65,0.0576241134751773
173.06,2020,Mobile Home,0,0,0,
173.06,2020,Multifamily,151,151,0,0
173.06,2020,Single Family - Detached,1140,1062,78,0.068421052631579
173.06,2025,Mobile Home,0,0,0,
173.06,2025,Multifamily,151,151,0,0
173.06,2025,Single Family - Detached,1142,1077,65,0.0569176882661996
173.06,2030,Mobile Home,0,0,0,
173.06,2030,Multifamily,151,151,0,0
173.06,2030,Single Family - Detached,1143,1077,66,0.057742782152231
173.06,2035,Mobile Home,0,0,0,
173.06,2035,Multifamily,151,151,0,0
173.06,2035,Single Family - Detached,1153,1088,65,0.0563746747614918
173.06,2040,Mobile Home,0,0,0,
173.06,2040,Multifamily,151,150,1,0.00662251655629139
173.06,2040,Single Family - Detached,1153,1085,68,0.0589765828274068
173.06,2045,Mobile Home,0,0,0,
173.06,2045,Multifamily,151,150,1,0.00662251655629139
173.06,2045,Single Family - Detached,1153,1084,69,0.0598438855160451
173.06,2050,Mobile Home,0,0,0,
173.06,2050,Multifamily,151,150,1,0.00662251655629139
173.06,2050,Single Family - Detached,1153,1085,68,0.0589765828274068
174.01,2012,Mobile Home,0,0,0,
174.01,2012,Multifamily,559,484,75,0.134168157423971
174.01,2012,Single Family - Detached,2209,2062,147,0.066545948392938
174.01,2020,Mobile Home,0,0,0,
174.01,2020,Multifamily,560,487,73,0.130357142857143
174.01,2020,Single Family - Detached,2220,2059,161,0.0725225225225225
174.01,2025,Mobile Home,0,0,0,
174.01,2025,Multifamily,581,516,65,0.111876075731497
174.01,2025,Single Family - Detached,2220,2061,159,0.0716216216216216
174.01,2030,Mobile Home,0,0,0,
174.01,2030,Multifamily,610,541,69,0.113114754098361
174.01,2030,Single Family - Detached,2224,2061,163,0.0732913669064748
174.01,2035,Mobile Home,0,0,0,
174.01,2035,Multifamily,636,569,67,0.105345911949686
174.01,2035,Single Family - Detached,2219,2068,151,0.0680486705723299
174.01,2040,Mobile Home,0,0,0,
174.01,2040,Multifamily,640,569,71,0.1109375
174.01,2040,Single Family - Detached,2236,2073,163,0.0728980322003578
174.01,2045,Mobile Home,0,0,0,
174.01,2045,Multifamily,640,569,71,0.1109375
174.01,2045,Single Family - Detached,2254,2074,180,0.0798580301685892
174.01,2050,Mobile Home,0,0,0,
174.01,2050,Multifamily,640,569,71,0.1109375
174.01,2050,Single Family - Detached,2276,2089,187,0.0821616871704745
174.03,2012,Mobile Home,0,0,0,
174.03,2012,Multifamily,44,44,0,0
174.03,2012,Single Family - Detached,2053,1979,74,0.0360448124695567
174.03,2020,Mobile Home,0,0,0,
174.03,2020,Multifamily,42,42,0,0
174.03,2020,Single Family - Detached,2096,2009,87,0.0415076335877863
174.03,2025,Mobile Home,0,0,0,
174.03,2025,Multifamily,37,37,0,0
174.03,2025,Single Family - Detached,2097,2028,69,0.0329041487839771
174.03,2030,Mobile Home,0,0,0,
174.03,2030,Multifamily,33,33,0,0
174.03,2030,Single Family - Detached,2098,2027,71,0.0338417540514776
174.03,2035,Mobile Home,0,0,0,
174.03,2035,Multifamily,27,27,0,0
174.03,2035,Single Family - Detached,2100,2035,65,0.030952380952381
174.03,2040,Mobile Home,0,0,0,
174.03,2040,Multifamily,20,20,0,0
174.03,2040,Single Family - Detached,2115,2040,75,0.0354609929078014
174.03,2045,Mobile Home,0,0,0,
174.03,2045,Multifamily,13,13,0,0
174.03,2045,Single Family - Detached,2135,2057,78,0.0365339578454333
174.03,2050,Mobile Home,0,0,0,
174.03,2050,Multifamily,6,6,0,0
174.03,2050,Single Family - Detached,2135,2057,78,0.0365339578454333
174.04,2012,Mobile Home,0,0,0,
174.04,2012,Multifamily,464,460,4,0.00862068965517241
174.04,2012,Single Family - Detached,2231,2129,102,0.0457194083370686
174.04,2020,Mobile Home,0,0,0,
174.04,2020,Multifamily,463,463,0,0
174.04,2020,Single Family - Detached,2264,2153,111,0.0490282685512368
174.04,2025,Mobile Home,0,0,0,
174.04,2025,Multifamily,458,458,0,0
174.04,2025,Single Family - Detached,2276,2183,93,0.0408611599297012
174.04,2030,Mobile Home,0,0,0,
174.04,2030,Multifamily,453,453,0,0
174.04,2030,Single Family - Detached,2287,2191,96,0.0419763882815916
174.04,2035,Mobile Home,0,0,0,
174.04,2035,Multifamily,448,448,0,0
174.04,2035,Single Family - Detached,2297,2209,88,0.0383108402263822
174.04,2040,Mobile Home,0,0,0,
174.04,2040,Multifamily,433,433,0,0
174.04,2040,Single Family - Detached,2350,2253,97,0.0412765957446809
174.04,2045,Mobile Home,0,0,0,
174.04,2045,Multifamily,418,418,0,0
174.04,2045,Single Family - Detached,2370,2262,108,0.0455696202531646
174.04,2050,Mobile Home,0,0,0,
174.04,2050,Multifamily,404,404,0,0
174.04,2050,Single Family - Detached,2398,2286,112,0.0467055879899917
175.01,2012,Mobile Home,0,0,0,
175.01,2012,Multifamily,360,322,38,0.105555555555556
175.01,2012,Single Family - Detached,1111,1038,73,0.0657065706570657
175.01,2020,Mobile Home,0,0,0,
175.01,2020,Multifamily,371,328,43,0.115902964959569
175.01,2020,Single Family - Detached,1113,1013,100,0.0898472596585804
175.01,2025,Mobile Home,0,0,0,
175.01,2025,Multifamily,371,325,46,0.123989218328841
175.01,2025,Single Family - Detached,1113,1049,64,0.0575022461814915
175.01,2030,Mobile Home,0,0,0,
175.01,2030,Multifamily,371,323,48,0.129380053908356
175.01,2030,Single Family - Detached,1113,1047,66,0.0592991913746631
175.01,2035,Mobile Home,0,0,0,
175.01,2035,Multifamily,371,323,48,0.129380053908356
175.01,2035,Single Family - Detached,1113,1050,63,0.0566037735849057
175.01,2040,Mobile Home,0,0,0,
175.01,2040,Multifamily,371,317,54,0.1455525606469
175.01,2040,Single Family - Detached,1113,1034,79,0.0709793351302785
175.01,2045,Mobile Home,0,0,0,
175.01,2045,Multifamily,511,443,68,0.13307240704501
175.01,2045,Single Family - Detached,1112,1013,99,0.0890287769784173
175.01,2050,Mobile Home,0,0,0,
175.01,2050,Multifamily,755,669,86,0.113907284768212
175.01,2050,Single Family - Detached,1106,1002,104,0.0940325497287523
175.02,2012,Mobile Home,0,0,0,
175.02,2012,Multifamily,161,157,4,0.0248447204968944
175.02,2012,Single Family - Detached,1089,1092,-3,-0.00275482093663912
175.02,2020,Mobile Home,0,0,0,
175.02,2020,Multifamily,174,169,5,0.028735632183908
175.02,2020,Single Family - Detached,1095,1089,6,0.00547945205479452
175.02,2025,Mobile Home,0,0,0,
175.02,2025,Multifamily,209,209,0,0
175.02,2025,Single Family - Detached,1087,1088,-1,-0.000919963201471941
175.02,2030,Mobile Home,0,0,0,
175.02,2030,Multifamily,209,209,0,0
175.02,2030,Single Family - Detached,1087,1087,0,0
175.02,2035,Mobile Home,0,0,0,
175.02,2035,Multifamily,209,209,0,0
175.02,2035,Single Family - Detached,1087,1088,-1,-0.000919963201471941
175.02,2040,Mobile Home,0,0,0,
175.02,2040,Multifamily,209,206,3,0.0143540669856459
175.02,2040,Single Family - Detached,1088,1083,5,0.00459558823529412
175.02,2045,Mobile Home,0,0,0,
175.02,2045,Multifamily,209,205,4,0.0191387559808612
175.02,2045,Single Family - Detached,1088,1075,13,0.0119485294117647
175.02,2050,Mobile Home,0,0,0,
175.02,2050,Multifamily,209,205,4,0.0191387559808612
175.02,2050,Single Family - Detached,1088,1071,17,0.015625
176.01,2012,Mobile Home,0,0,0,
176.01,2012,Multifamily,754,682,72,0.0954907161803713
176.01,2012,Single Family - Detached,1513,1469,44,0.0290812954395241
176.01,2020,Mobile Home,0,0,0,
176.01,2020,Multifamily,754,682,72,0.0954907161803713
176.01,2020,Single Family - Detached,1577,1531,46,0.0291693088142042
176.01,2025,Mobile Home,0,0,0,
176.01,2025,Multifamily,754,686,68,0.0901856763925729
176.01,2025,Single Family - Detached,1649,1614,35,0.0212249848392965
176.01,2030,Mobile Home,0,0,0,
176.01,2030,Multifamily,754,686,68,0.0901856763925729
176.01,2030,Single Family - Detached,1725,1684,41,0.023768115942029
176.01,2035,Mobile Home,0,0,0,
176.01,2035,Multifamily,754,687,67,0.0888594164456233
176.01,2035,Single Family - Detached,1739,1700,39,0.0224266820011501
176.01,2040,Mobile Home,0,0,0,
176.01,2040,Multifamily,754,687,67,0.0888594164456233
176.01,2040,Single Family - Detached,1739,1698,41,0.0235767682576193
176.01,2045,Mobile Home,0,0,0,
176.01,2045,Multifamily,754,687,67,0.0888594164456233
176.01,2045,Single Family - Detached,1739,1694,45,0.0258769407705578
176.01,2050,Mobile Home,0,0,0,
176.01,2050,Multifamily,754,687,67,0.0888594164456233
176.01,2050,Single Family - Detached,1739,1694,45,0.0258769407705578
176.03,2012,Mobile Home,0,0,0,
176.03,2012,Multifamily,138,138,0,0
176.03,2012,Single Family - Detached,851,828,23,0.027027027027027
176.03,2020,Mobile Home,0,0,0,
176.03,2020,Multifamily,140,140,0,0
176.03,2020,Single Family - Detached,858,829,29,0.0337995337995338
176.03,2025,Mobile Home,0,0,0,
176.03,2025,Multifamily,155,155,0,0
176.03,2025,Single Family - Detached,858,837,21,0.0244755244755245
176.03,2030,Mobile Home,0,0,0,
176.03,2030,Multifamily,155,155,0,0
176.03,2030,Single Family - Detached,858,837,21,0.0244755244755245
176.03,2035,Mobile Home,0,0,0,
176.03,2035,Multifamily,155,155,0,0
176.03,2035,Single Family - Detached,864,843,21,0.0243055555555556
176.03,2040,Mobile Home,0,0,0,
176.03,2040,Multifamily,155,155,0,0
176.03,2040,Single Family - Detached,892,867,25,0.0280269058295964
176.03,2045,Mobile Home,0,0,0,
176.03,2045,Multifamily,155,155,0,0
176.03,2045,Single Family - Detached,892,863,29,0.0325112107623318
176.03,2050,Mobile Home,0,0,0,
176.03,2050,Multifamily,155,155,0,0
176.03,2050,Single Family - Detached,892,861,31,0.0347533632286996
176.04,2012,Mobile Home,233,230,3,0.0128755364806867
176.04,2012,Multifamily,1412,1355,57,0.0403682719546742
176.04,2012,Single Family - Detached,1582,1493,89,0.0562579013906448
176.04,2020,Mobile Home,233,231,2,0.00858369098712446
176.04,2020,Multifamily,1416,1360,56,0.0395480225988701
176.04,2020,Single Family - Detached,1689,1590,99,0.0586145648312611
176.04,2025,Mobile Home,233,231,2,0.00858369098712446
176.04,2025,Multifamily,1416,1365,51,0.0360169491525424
176.04,2025,Single Family - Detached,1689,1603,86,0.0509177027827117
176.04,2030,Mobile Home,233,230,3,0.0128755364806867
176.04,2030,Multifamily,1416,1365,51,0.0360169491525424
176.04,2030,Single Family - Detached,1689,1601,88,0.0521018354055654
176.04,2035,Mobile Home,233,230,3,0.0128755364806867
176.04,2035,Multifamily,1416,1366,50,0.0353107344632768
176.04,2035,Single Family - Detached,1716,1635,81,0.0472027972027972
176.04,2040,Mobile Home,233,231,2,0.00858369098712446
176.04,2040,Multifamily,1416,1364,52,0.0367231638418079
176.04,2040,Single Family - Detached,1747,1661,86,0.0492272467086434
176.04,2045,Mobile Home,233,230,3,0.0128755364806867
176.04,2045,Multifamily,1416,1364,52,0.0367231638418079
176.04,2045,Single Family - Detached,1757,1668,89,0.0506545247581104
176.04,2050,Mobile Home,233,225,8,0.0343347639484979
176.04,2050,Multifamily,1416,1363,53,0.0374293785310734
176.04,2050,Single Family - Detached,1759,1670,89,0.0505969300739056
177.01,2012,Mobile Home,257,248,9,0.0350194552529183
177.01,2012,Multifamily,661,640,21,0.0317700453857791
177.01,2012,Single Family - Detached,1680,1479,201,0.119642857142857
177.01,2020,Mobile Home,257,249,8,0.0311284046692607
177.01,2020,Multifamily,665,647,18,0.0270676691729323
177.01,2020,Single Family - Detached,1786,1595,191,0.106942889137738
177.01,2025,Mobile Home,257,248,9,0.0350194552529183
177.01,2025,Multifamily,838,823,15,0.0178997613365155
177.01,2025,Single Family - Detached,1767,1583,184,0.10413129598189
177.01,2030,Mobile Home,257,246,11,0.0428015564202335
177.01,2030,Multifamily,893,875,18,0.0201567749160134
177.01,2030,Single Family - Detached,1776,1591,185,0.104166666666667
177.01,2035,Mobile Home,257,246,11,0.0428015564202335
177.01,2035,Multifamily,894,876,18,0.0201342281879195
177.01,2035,Single Family - Detached,1776,1592,184,0.103603603603604
177.01,2040,Mobile Home,257,247,10,0.0389105058365759
177.01,2040,Multifamily,904,885,19,0.0210176991150442
177.01,2040,Single Family - Detached,1776,1591,185,0.104166666666667
177.01,2045,Mobile Home,257,246,11,0.0428015564202335
177.01,2045,Multifamily,916,894,22,0.0240174672489083
177.01,2045,Single Family - Detached,1778,1593,185,0.104049493813273
177.01,2050,Mobile Home,257,239,18,0.0700389105058366
177.01,2050,Multifamily,926,901,25,0.0269978401727862
177.01,2050,Single Family - Detached,1782,1597,185,0.10381593714927
177.02,2012,Mobile Home,286,257,29,0.101398601398601
177.02,2012,Multifamily,142,114,28,0.197183098591549
177.02,2012,Single Family - Detached,1057,989,68,0.0643330179754021
177.02,2020,Mobile Home,286,258,28,0.0979020979020979
177.02,2020,Multifamily,157,129,28,0.178343949044586
177.02,2020,Single Family - Detached,1067,979,88,0.0824742268041237
177.02,2025,Mobile Home,286,258,28,0.0979020979020979
177.02,2025,Multifamily,154,127,27,0.175324675324675
177.02,2025,Single Family - Detached,1067,1005,62,0.0581068416119963
177.02,2030,Mobile Home,286,257,29,0.101398601398601
177.02,2030,Multifamily,174,145,29,0.166666666666667
177.02,2030,Single Family - Detached,1066,1001,65,0.0609756097560976
177.02,2035,Mobile Home,286,257,29,0.101398601398601
177.02,2035,Multifamily,195,170,25,0.128205128205128
177.02,2035,Single Family - Detached,1066,1001,65,0.0609756097560976
177.02,2040,Mobile Home,286,257,29,0.101398601398601
177.02,2040,Multifamily,400,359,41,0.1025
177.02,2040,Single Family - Detached,1057,986,71,0.0671712393566698
177.02,2045,Mobile Home,286,256,30,0.104895104895105
177.02,2045,Multifamily,497,446,51,0.10261569416499
177.02,2045,Single Family - Detached,1053,973,80,0.0759734093067426
177.02,2050,Mobile Home,286,253,33,0.115384615384615
177.02,2050,Multifamily,499,444,55,0.110220440881764
177.02,2050,Single Family - Detached,1053,969,84,0.0797720797720798
178.01,2012,Mobile Home,0,0,0,
178.01,2012,Multifamily,887,832,55,0.0620067643742954
178.01,2012,Single Family - Detached,1839,1837,2,0.00108754758020663
178.01,2020,Mobile Home,0,0,0,
178.01,2020,Multifamily,887,825,62,0.0698985343855693
178.01,2020,Single Family - Detached,1929,1892,37,0.0191809227579057
178.01,2025,Mobile Home,0,0,0,
178.01,2025,Multifamily,887,825,62,0.0698985343855693
178.01,2025,Single Family - Detached,1951,1918,33,0.0169144028703229
178.01,2030,Mobile Home,0,0,0,
178.01,2030,Multifamily,887,825,62,0.0698985343855693
178.01,2030,Single Family - Detached,1968,1934,34,0.0172764227642276
178.01,2035,Mobile Home,0,0,0,
178.01,2035,Multifamily,887,825,62,0.0698985343855693
178.01,2035,Single Family - Detached,2032,2004,28,0.0137795275590551
178.01,2040,Mobile Home,0,0,0,
178.01,2040,Multifamily,887,825,62,0.0698985343855693
178.01,2040,Single Family - Detached,2032,2002,30,0.0147637795275591
178.01,2045,Mobile Home,0,0,0,
178.01,2045,Multifamily,887,825,62,0.0698985343855693
178.01,2045,Single Family - Detached,2032,2000,32,0.015748031496063
178.01,2050,Mobile Home,0,0,0,
178.01,2050,Multifamily,887,825,62,0.0698985343855693
178.01,2050,Single Family - Detached,2032,2000,32,0.015748031496063
178.08,2012,Mobile Home,0,0,0,
178.08,2012,Multifamily,108,112,-4,-0.037037037037037
178.08,2012,Single Family - Detached,2476,2300,176,0.0710823909531502
178.08,2020,Mobile Home,0,0,0,
178.08,2020,Multifamily,108,112,-4,-0.037037037037037
178.08,2020,Single Family - Detached,2512,2319,193,0.0768312101910828
178.08,2025,Mobile Home,0,0,0,
178.08,2025,Multifamily,108,113,-5,-0.0462962962962963
178.08,2025,Single Family - Detached,2512,2356,156,0.0621019108280255
178.08,2030,Mobile Home,0,0,0,
178.08,2030,Multifamily,108,113,-5,-0.0462962962962963
178.08,2030,Single Family - Detached,2512,2354,158,0.0628980891719745
178.08,2035,Mobile Home,0,0,0,
178.08,2035,Multifamily,108,114,-6,-0.0555555555555556
178.08,2035,Single Family - Detached,2627,2477,150,0.0570993528740008
178.08,2040,Mobile Home,0,0,0,
178.08,2040,Multifamily,108,113,-5,-0.0462962962962963
178.08,2040,Single Family - Detached,2627,2475,152,0.0578606775789874
178.08,2045,Mobile Home,0,0,0,
178.08,2045,Multifamily,108,113,-5,-0.0462962962962963
178.08,2045,Single Family - Detached,2627,2473,154,0.0586220022839741
178.08,2050,Mobile Home,0,0,0,
178.08,2050,Multifamily,108,113,-5,-0.0462962962962963
178.08,2050,Single Family - Detached,2627,2473,154,0.0586220022839741
178.09,2012,Mobile Home,0,0,0,
178.09,2012,Multifamily,63,63,0,0
178.09,2012,Single Family - Detached,816,794,22,0.0269607843137255
178.09,2020,Mobile Home,0,0,0,
178.09,2020,Multifamily,63,59,4,0.0634920634920635
178.09,2020,Single Family - Detached,867,848,19,0.0219146482122261
178.09,2025,Mobile Home,0,0,0,
178.09,2025,Multifamily,63,58,5,0.0793650793650794
178.09,2025,Single Family - Detached,881,867,14,0.0158910329171396
178.09,2030,Mobile Home,0,0,0,
178.09,2030,Multifamily,63,58,5,0.0793650793650794
178.09,2030,Single Family - Detached,884,867,17,0.0192307692307692
178.09,2035,Mobile Home,0,0,0,
178.09,2035,Multifamily,63,59,4,0.0634920634920635
178.09,2035,Single Family - Detached,884,871,13,0.0147058823529412
178.09,2040,Mobile Home,0,0,0,
178.09,2040,Multifamily,63,58,5,0.0793650793650794
178.09,2040,Single Family - Detached,884,867,17,0.0192307692307692
178.09,2045,Mobile Home,0,0,0,
178.09,2045,Multifamily,63,57,6,0.0952380952380952
178.09,2045,Single Family - Detached,884,865,19,0.0214932126696833
178.09,2050,Mobile Home,0,0,0,
178.09,2050,Multifamily,63,56,7,0.111111111111111
178.09,2050,Single Family - Detached,884,865,19,0.0214932126696833
178.10,2012,Mobile Home,20,19,1,0.05
178.10,2012,Multifamily,527,490,37,0.0702087286527514
178.10,2012,Single Family - Detached,1622,1531,91,0.0561035758323058
178.10,2020,Mobile Home,20,6,14,0.7
178.10,2020,Multifamily,544,519,25,0.0459558823529412
178.10,2020,Single Family - Detached,1718,1640,78,0.0454016298020955
178.10,2025,Mobile Home,20,6,14,0.7
178.10,2025,Multifamily,544,521,23,0.0422794117647059
178.10,2025,Single Family - Detached,1735,1681,54,0.0311239193083573
178.10,2030,Mobile Home,20,5,15,0.75
178.10,2030,Multifamily,544,521,23,0.0422794117647059
178.10,2030,Single Family - Detached,1776,1722,54,0.0304054054054054
178.10,2035,Mobile Home,20,5,15,0.75
178.10,2035,Multifamily,544,522,22,0.0404411764705882
178.10,2035,Single Family - Detached,1796,1742,54,0.0300668151447661
178.10,2040,Mobile Home,20,5,15,0.75
178.10,2040,Multifamily,544,520,24,0.0441176470588235
178.10,2040,Single Family - Detached,1796,1742,54,0.0300668151447661
178.10,2045,Mobile Home,20,5,15,0.75
178.10,2045,Multifamily,544,520,24,0.0441176470588235
178.10,2045,Single Family - Detached,1796,1742,54,0.0300668151447661
178.10,2050,Mobile Home,20,4,16,0.8
178.10,2050,Multifamily,544,520,24,0.0441176470588235
178.10,2050,Single Family - Detached,1796,1742,54,0.0300668151447661
178.11,2012,Mobile Home,0,0,0,
178.11,2012,Multifamily,976,886,90,0.0922131147540984
178.11,2012,Single Family - Detached,2033,1867,166,0.0816527299557304
178.11,2020,Mobile Home,0,0,0,
178.11,2020,Multifamily,976,886,90,0.0922131147540984
178.11,2020,Single Family - Detached,2037,1866,171,0.0839469808541973
178.11,2025,Mobile Home,0,0,0,
178.11,2025,Multifamily,976,887,89,0.0911885245901639
178.11,2025,Single Family - Detached,2037,1887,150,0.0736377025036819
178.11,2030,Mobile Home,0,0,0,
178.11,2030,Multifamily,976,887,89,0.0911885245901639
178.11,2030,Single Family - Detached,2037,1885,152,0.0746195385370643
178.11,2035,Mobile Home,0,0,0,
178.11,2035,Multifamily,976,888,88,0.0901639344262295
178.11,2035,Single Family - Detached,2037,1887,150,0.0736377025036819
178.11,2040,Mobile Home,0,0,0,
178.11,2040,Multifamily,976,887,89,0.0911885245901639
178.11,2040,Single Family - Detached,2037,1885,152,0.0746195385370643
178.11,2045,Mobile Home,0,0,0,
178.11,2045,Multifamily,976,887,89,0.0911885245901639
178.11,2045,Single Family - Detached,2037,1884,153,0.0751104565537555
178.11,2050,Mobile Home,0,0,0,
178.11,2050,Multifamily,976,887,89,0.0911885245901639
178.11,2050,Single Family - Detached,2037,1884,153,0.0751104565537555
178.13,2012,Mobile Home,657,480,177,0.269406392694064
178.13,2012,Multifamily,329,293,36,0.109422492401216
178.13,2012,Single Family - Detached,1269,1066,203,0.159968479117415
178.13,2020,Mobile Home,657,482,175,0.266362252663623
178.13,2020,Multifamily,485,437,48,0.0989690721649484
178.13,2020,Single Family - Detached,1275,1067,208,0.163137254901961
178.13,2025,Mobile Home,657,481,176,0.267884322678843
178.13,2025,Multifamily,488,446,42,0.0860655737704918
178.13,2025,Single Family - Detached,1273,1092,181,0.142183817753339
178.13,2030,Mobile Home,657,478,179,0.272450532724505
178.13,2030,Multifamily,490,446,44,0.0897959183673469
178.13,2030,Single Family - Detached,1278,1095,183,0.143192488262911
178.13,2035,Mobile Home,657,478,179,0.272450532724505
178.13,2035,Multifamily,492,451,41,0.0833333333333333
178.13,2035,Single Family - Detached,1280,1108,172,0.134375
178.13,2040,Mobile Home,657,479,178,0.270928462709285
178.13,2040,Multifamily,499,455,44,0.0881763527054108
178.13,2040,Single Family - Detached,1280,1108,172,0.134375
178.13,2045,Mobile Home,657,477,180,0.273972602739726
178.13,2045,Multifamily,499,454,45,0.0901803607214429
178.13,2045,Single Family - Detached,1280,1107,173,0.13515625
178.13,2050,Mobile Home,657,467,190,0.289193302891933
178.13,2050,Multifamily,499,453,46,0.0921843687374749
178.13,2050,Single Family - Detached,1280,1108,172,0.134375
179,2012,Mobile Home,25,21,4,0.16
179,2012,Multifamily,2232,2038,194,0.0869175627240143
179,2012,Single Family - Detached,955,903,52,0.0544502617801047
179,2020,Mobile Home,25,22,3,0.12
179,2020,Multifamily,2463,2239,224,0.0909460008120179
179,2020,Single Family - Detached,1018,924,94,0.0923379174852652
179,2025,Mobile Home,25,21,4,0.16
179,2025,Multifamily,2831,2613,218,0.0770045920169551
179,2025,Single Family - Detached,1008,934,74,0.0734126984126984
179,2030,Mobile Home,25,21,4,0.16
179,2030,Multifamily,3056,2762,294,0.0962041884816754
179,2030,Single Family - Detached,1047,959,88,0.0840496657115568
179,2035,Mobile Home,25,22,3,0.12
179,2035,Multifamily,3188,2918,270,0.0846925972396487
179,2035,Single Family - Detached,1128,1052,76,0.0673758865248227
179,2040,Mobile Home,25,22,3,0.12
179,2040,Multifamily,3244,3036,208,0.064118372379778
179,2040,Single Family - Detached,1129,1049,80,0.070859167404783
179,2045,Mobile Home,25,22,3,0.12
179,2045,Multifamily,3244,3033,211,0.0650431565967941
179,2045,Single Family - Detached,1130,1040,90,0.079646017699115
179,2050,Mobile Home,25,22,3,0.12
179,2050,Multifamily,3244,3030,214,0.0659679408138101
179,2050,Single Family - Detached,1134,1039,95,0.0837742504409171
18,2012,Mobile Home,0,0,0,
18,2012,Multifamily,2071,1925,146,0.0704973442781265
18,2012,Single Family - Detached,685,665,20,0.0291970802919708
18,2020,Mobile Home,0,0,0,
18,2020,Multifamily,2231,2105,126,0.0564769161810847
18,2020,Single Family - Detached,666,649,17,0.0255255255255255
18,2025,Mobile Home,0,0,0,
18,2025,Multifamily,2489,2403,86,0.03455202892728
18,2025,Single Family - Detached,632,626,6,0.00949367088607595
18,2030,Mobile Home,0,0,0,
18,2030,Multifamily,2557,2470,87,0.0340242471646461
18,2030,Single Family - Detached,612,603,9,0.0147058823529412
18,2035,Mobile Home,0,0,0,
18,2035,Multifamily,2575,2519,56,0.021747572815534
18,2035,Single Family - Detached,600,597,3,0.005
18,2040,Mobile Home,0,0,0,
18,2040,Multifamily,2575,2501,74,0.0287378640776699
18,2040,Single Family - Detached,600,588,12,0.02
18,2045,Mobile Home,0,0,0,
18,2045,Multifamily,2575,2495,80,0.0310679611650485
18,2045,Single Family - Detached,611,591,20,0.0327332242225859
18,2050,Mobile Home,0,0,0,
18,2050,Multifamily,2575,2495,80,0.0310679611650485
18,2050,Single Family - Detached,612,591,21,0.0343137254901961
180,2012,Mobile Home,0,0,0,
180,2012,Multifamily,1695,1476,219,0.129203539823009
180,2012,Single Family - Detached,522,408,114,0.218390804597701
180,2020,Mobile Home,0,0,0,
180,2020,Multifamily,1716,1485,231,0.134615384615385
180,2020,Single Family - Detached,536,441,95,0.177238805970149
180,2025,Mobile Home,0,0,0,
180,2025,Multifamily,1764,1542,222,0.125850340136054
180,2025,Single Family - Detached,532,453,79,0.148496240601504
180,2030,Mobile Home,0,0,0,
180,2030,Multifamily,1906,1719,187,0.0981112277019937
180,2030,Single Family - Detached,530,458,72,0.135849056603774
180,2035,Mobile Home,0,0,0,
180,2035,Multifamily,1944,1741,203,0.104423868312757
180,2035,Single Family - Detached,540,459,81,0.15
180,2040,Mobile Home,0,0,0,
180,2040,Multifamily,2109,1931,178,0.0844001896633476
180,2040,Single Family - Detached,539,460,79,0.146567717996289
180,2045,Mobile Home,0,0,0,
180,2045,Multifamily,2109,1931,178,0.0844001896633476
180,2045,Single Family - Detached,539,456,83,0.153988868274583
180,2050,Mobile Home,0,0,0,
180,2050,Multifamily,2109,1931,178,0.0844001896633476
180,2050,Single Family - Detached,540,456,84,0.155555555555556
181,2012,Mobile Home,714,541,173,0.242296918767507
181,2012,Multifamily,740,606,134,0.181081081081081
181,2012,Single Family - Detached,1548,1349,199,0.128552971576227
181,2020,Mobile Home,505,416,89,0.176237623762376
181,2020,Multifamily,1221,1014,207,0.16953316953317
181,2020,Single Family - Detached,1546,1342,204,0.131953428201811
181,2025,Mobile Home,505,416,89,0.176237623762376
181,2025,Multifamily,1321,1154,167,0.126419379258138
181,2025,Single Family - Detached,1546,1361,185,0.119663648124191
181,2030,Mobile Home,505,416,89,0.176237623762376
181,2030,Multifamily,1376,1188,188,0.136627906976744
181,2030,Single Family - Detached,1546,1360,186,0.120310478654593
181,2035,Mobile Home,505,416,89,0.176237623762376
181,2035,Multifamily,1402,1225,177,0.126248216833096
181,2035,Single Family - Detached,1546,1367,179,0.115782664941785
181,2040,Mobile Home,505,408,97,0.192079207920792
181,2040,Multifamily,1402,1252,150,0.106990014265335
181,2040,Single Family - Detached,1546,1365,181,0.117076326002587
181,2045,Mobile Home,505,408,97,0.192079207920792
181,2045,Multifamily,1402,1242,160,0.114122681883024
181,2045,Single Family - Detached,1546,1365,181,0.117076326002587
181,2050,Mobile Home,505,404,101,0.2
181,2050,Multifamily,1402,1233,169,0.120542082738944
181,2050,Single Family - Detached,1546,1364,182,0.117723156532988
182,2012,Mobile Home,174,65,109,0.626436781609195
182,2012,Multifamily,1479,1378,101,0.068289384719405
182,2012,Single Family - Detached,1054,976,78,0.0740037950664137
182,2020,Mobile Home,174,57,117,0.672413793103448
182,2020,Multifamily,1558,1377,181,0.11617458279846
182,2020,Single Family - Detached,1054,949,105,0.0996204933586338
182,2025,Mobile Home,174,56,118,0.67816091954023
182,2025,Multifamily,1572,1436,136,0.0865139949109415
182,2025,Single Family - Detached,1050,985,65,0.0619047619047619
182,2030,Mobile Home,174,54,120,0.689655172413793
182,2030,Multifamily,1573,1413,160,0.101716465352829
182,2030,Single Family - Detached,1050,981,69,0.0657142857142857
182,2035,Mobile Home,174,55,119,0.683908045977011
182,2035,Multifamily,1673,1497,176,0.105200239091452
182,2035,Single Family - Detached,1050,992,58,0.0552380952380952
182,2040,Mobile Home,170,95,75,0.441176470588235
182,2040,Multifamily,1697,1584,113,0.0665880966411314
182,2040,Single Family - Detached,1050,981,69,0.0657142857142857
182,2045,Mobile Home,170,95,75,0.441176470588235
182,2045,Multifamily,1759,1603,156,0.0886867538374076
182,2045,Single Family - Detached,1049,978,71,0.0676835081029552
182,2050,Mobile Home,170,93,77,0.452941176470588
182,2050,Multifamily,1777,1596,181,0.101857062464828
182,2050,Single Family - Detached,1047,970,77,0.0735434574976122
183,2012,Mobile Home,0,0,0,
183,2012,Multifamily,1941,1036,905,0.466254507985574
183,2012,Single Family - Detached,409,248,161,0.393643031784841
183,2020,Mobile Home,0,0,0,
183,2020,Multifamily,2086,1175,911,0.436720997123682
183,2020,Single Family - Detached,426,264,162,0.380281690140845
183,2025,Mobile Home,0,0,0,
183,2025,Multifamily,2086,1199,887,0.425215723873442
183,2025,Single Family - Detached,427,289,138,0.323185011709602
183,2030,Mobile Home,0,0,0,
183,2030,Multifamily,2094,1240,854,0.407831900668577
183,2030,Single Family - Detached,428,289,139,0.324766355140187
183,2035,Mobile Home,0,0,0,
183,2035,Multifamily,2126,1301,825,0.388052681091251
183,2035,Single Family - Detached,427,302,125,0.292740046838407
183,2040,Mobile Home,0,0,0,
183,2040,Multifamily,2127,1335,792,0.372355430183357
183,2040,Single Family - Detached,428,298,130,0.303738317757009
183,2045,Mobile Home,0,0,0,
183,2045,Multifamily,2143,1351,792,0.369575361642557
183,2045,Single Family - Detached,429,299,130,0.303030303030303
183,2050,Mobile Home,0,0,0,
183,2050,Multifamily,2168,1398,770,0.355166051660517
183,2050,Single Family - Detached,430,297,133,0.309302325581395
184,2012,Mobile Home,231,101,130,0.562770562770563
184,2012,Multifamily,1063,989,74,0.0696142991533396
184,2012,Single Family - Detached,555,460,95,0.171171171171171
184,2020,Mobile Home,231,93,138,0.597402597402597
184,2020,Multifamily,1275,1084,191,0.149803921568627
184,2020,Single Family - Detached,579,467,112,0.193436960276339
184,2025,Mobile Home,231,93,138,0.597402597402597
184,2025,Multifamily,1260,1108,152,0.120634920634921
184,2025,Single Family - Detached,577,487,90,0.155979202772964
184,2030,Mobile Home,231,92,139,0.601731601731602
184,2030,Multifamily,1225,1061,164,0.133877551020408
184,2030,Single Family - Detached,545,455,90,0.165137614678899
184,2035,Mobile Home,231,93,138,0.597402597402597
184,2035,Multifamily,1197,1039,158,0.131996658312448
184,2035,Single Family - Detached,513,428,85,0.165692007797271
184,2040,Mobile Home,231,83,148,0.640692640692641
184,2040,Multifamily,1199,1086,113,0.0942452043369475
184,2040,Single Family - Detached,513,418,95,0.185185185185185
184,2045,Mobile Home,231,81,150,0.649350649350649
184,2045,Multifamily,1207,1071,136,0.112676056338028
184,2045,Single Family - Detached,513,417,96,0.187134502923977
184,2050,Mobile Home,231,77,154,0.666666666666667
184,2050,Multifamily,1207,1049,158,0.130903065451533
184,2050,Single Family - Detached,513,413,100,0.194931773879142
185.04,2012,Mobile Home,0,0,0,
185.04,2012,Multifamily,727,687,40,0.0550206327372765
185.04,2012,Single Family - Detached,1922,1861,61,0.0317377731529657
185.04,2020,Mobile Home,0,0,0,
185.04,2020,Multifamily,727,680,47,0.0646492434662999
185.04,2020,Single Family - Detached,1923,1856,67,0.0348413936557462
185.04,2025,Mobile Home,0,0,0,
185.04,2025,Multifamily,868,817,51,0.0587557603686636
185.04,2025,Single Family - Detached,1937,1894,43,0.0221992772328343
185.04,2030,Mobile Home,0,0,0,
185.04,2030,Multifamily,1354,1293,61,0.0450516986706056
185.04,2030,Single Family - Detached,1937,1894,43,0.0221992772328343
185.04,2035,Mobile Home,0,0,0,
185.04,2035,Multifamily,1401,1346,55,0.0392576730906495
185.04,2035,Single Family - Detached,1937,1893,44,0.022715539494063
185.04,2040,Mobile Home,0,0,0,
185.04,2040,Multifamily,1401,1347,54,0.0385438972162741
185.04,2040,Single Family - Detached,1937,1892,45,0.0232318017552917
185.04,2045,Mobile Home,0,0,0,
185.04,2045,Multifamily,1401,1346,55,0.0392576730906495
185.04,2045,Single Family - Detached,1937,1892,45,0.0232318017552917
185.04,2050,Mobile Home,0,0,0,
185.04,2050,Multifamily,1401,1346,55,0.0392576730906495
185.04,2050,Single Family - Detached,1937,1891,46,0.0237480640165204
185.07,2012,Mobile Home,489,476,13,0.0265848670756646
185.07,2012,Multifamily,146,144,2,0.0136986301369863
185.07,2012,Single Family - Detached,2494,2214,280,0.112269446672013
185.07,2020,Mobile Home,489,478,11,0.0224948875255624
185.07,2020,Multifamily,146,143,3,0.0205479452054795
185.07,2020,Single Family - Detached,2494,2199,295,0.118283881315156
185.07,2025,Mobile Home,489,477,12,0.0245398773006135
185.07,2025,Multifamily,146,146,0,0
185.07,2025,Single Family - Detached,2494,2242,252,0.101042502004812
185.07,2030,Mobile Home,489,474,15,0.0306748466257669
185.07,2030,Multifamily,146,144,2,0.0136986301369863
185.07,2030,Single Family - Detached,2494,2238,256,0.102646351242983
185.07,2035,Mobile Home,489,475,14,0.0286298568507157
185.07,2035,Multifamily,146,146,0,0
185.07,2035,Single Family - Detached,2494,2252,242,0.0970328789093825
185.07,2040,Mobile Home,489,476,13,0.0265848670756646
185.07,2040,Multifamily,146,144,2,0.0136986301369863
185.07,2040,Single Family - Detached,2494,2307,187,0.0749799518845229
185.07,2045,Mobile Home,489,473,16,0.032719836400818
185.07,2045,Multifamily,146,144,2,0.0136986301369863
185.07,2045,Single Family - Detached,2494,2296,198,0.0793905372894948
185.07,2050,Mobile Home,489,462,27,0.0552147239263804
185.07,2050,Multifamily,146,144,2,0.0136986301369863
185.07,2050,Single Family - Detached,2568,2360,208,0.0809968847352025
185.09,2012,Mobile Home,0,0,0,
185.09,2012,Multifamily,1191,1145,46,0.0386230058774139
185.09,2012,Single Family - Detached,525,465,60,0.114285714285714
185.09,2020,Mobile Home,0,0,0,
185.09,2020,Multifamily,1261,1203,58,0.0459952418715305
185.09,2020,Single Family - Detached,525,455,70,0.133333333333333
185.09,2025,Mobile Home,0,0,0,
185.09,2025,Multifamily,1261,1207,54,0.0428231562252181
185.09,2025,Single Family - Detached,525,471,54,0.102857142857143
185.09,2030,Mobile Home,0,0,0,
185.09,2030,Multifamily,1468,1399,69,0.0470027247956403
185.09,2030,Single Family - Detached,526,468,58,0.110266159695817
185.09,2035,Mobile Home,0,0,0,
185.09,2035,Multifamily,1960,1867,93,0.0474489795918367
185.09,2035,Single Family - Detached,551,519,32,0.058076225045372
185.09,2040,Mobile Home,0,0,0,
185.09,2040,Multifamily,1960,1868,92,0.0469387755102041
185.09,2040,Single Family - Detached,557,528,29,0.052064631956912
185.09,2045,Mobile Home,0,0,0,
185.09,2045,Multifamily,1960,1868,92,0.0469387755102041
185.09,2045,Single Family - Detached,557,524,33,0.059245960502693
185.09,2050,Mobile Home,0,0,0,
185.09,2050,Multifamily,1960,1868,92,0.0469387755102041
185.09,2050,Single Family - Detached,560,524,36,0.0642857142857143
185.10,2012,Mobile Home,0,0,0,
185.10,2012,Multifamily,109,100,9,0.0825688073394495
185.10,2012,Single Family - Detached,783,754,29,0.037037037037037
185.10,2020,Mobile Home,0,0,0,
185.10,2020,Multifamily,109,99,10,0.0917431192660551
185.10,2020,Single Family - Detached,783,750,33,0.0421455938697318
185.10,2025,Mobile Home,0,0,0,
185.10,2025,Multifamily,109,101,8,0.073394495412844
185.10,2025,Single Family - Detached,798,771,27,0.0338345864661654
185.10,2030,Mobile Home,0,0,0,
185.10,2030,Multifamily,109,99,10,0.0917431192660551
185.10,2030,Single Family - Detached,805,776,29,0.0360248447204969
185.10,2035,Mobile Home,0,0,0,
185.10,2035,Multifamily,109,99,10,0.0917431192660551
185.10,2035,Single Family - Detached,805,776,29,0.0360248447204969
185.10,2040,Mobile Home,0,0,0,
185.10,2040,Multifamily,109,101,8,0.073394495412844
185.10,2040,Single Family - Detached,805,776,29,0.0360248447204969
185.10,2045,Mobile Home,0,0,0,
185.10,2045,Multifamily,109,100,9,0.0825688073394495
185.10,2045,Single Family - Detached,805,776,29,0.0360248447204969
185.10,2050,Mobile Home,0,0,0,
185.10,2050,Multifamily,109,100,9,0.0825688073394495
185.10,2050,Single Family - Detached,805,775,30,0.0372670807453416
185.11,2012,Mobile Home,70,68,2,0.0285714285714286
185.11,2012,Multifamily,1015,955,60,0.0591133004926108
185.11,2012,Single Family - Detached,810,792,18,0.0222222222222222
185.11,2020,Mobile Home,70,69,1,0.0142857142857143
185.11,2020,Multifamily,1079,1043,36,0.0333642261353105
185.11,2020,Single Family - Detached,810,789,21,0.0259259259259259
185.11,2025,Mobile Home,70,69,1,0.0142857142857143
185.11,2025,Multifamily,1204,1170,34,0.0282392026578073
185.11,2025,Single Family - Detached,813,799,14,0.017220172201722
185.11,2030,Mobile Home,70,69,1,0.0142857142857143
185.11,2030,Multifamily,1204,1167,37,0.0307308970099668
185.11,2030,Single Family - Detached,849,832,17,0.0200235571260306
185.11,2035,Mobile Home,70,69,1,0.0142857142857143
185.11,2035,Multifamily,1204,1166,38,0.0315614617940199
185.11,2035,Single Family - Detached,866,848,18,0.0207852193995381
185.11,2040,Mobile Home,70,69,1,0.0142857142857143
185.11,2040,Multifamily,1204,1166,38,0.0315614617940199
185.11,2040,Single Family - Detached,866,848,18,0.0207852193995381
185.11,2045,Mobile Home,70,69,1,0.0142857142857143
185.11,2045,Multifamily,1204,1166,38,0.0315614617940199
185.11,2045,Single Family - Detached,866,848,18,0.0207852193995381
185.11,2050,Mobile Home,70,68,2,0.0285714285714286
185.11,2050,Multifamily,1204,1166,38,0.0315614617940199
185.11,2050,Single Family - Detached,866,847,19,0.0219399538106236
185.12,2012,Mobile Home,0,0,0,
185.12,2012,Multifamily,392,388,4,0.0102040816326531
185.12,2012,Single Family - Detached,1799,1588,211,0.117287381878822
185.12,2020,Mobile Home,0,0,0,
185.12,2020,Multifamily,590,575,15,0.0254237288135593
185.12,2020,Single Family - Detached,1828,1605,223,0.12199124726477
185.12,2025,Mobile Home,0,0,0,
185.12,2025,Multifamily,590,581,9,0.0152542372881356
185.12,2025,Single Family - Detached,1828,1633,195,0.106673960612691
185.12,2030,Mobile Home,0,0,0,
185.12,2030,Multifamily,590,580,10,0.0169491525423729
185.12,2030,Single Family - Detached,1828,1630,198,0.108315098468271
185.12,2035,Mobile Home,0,0,0,
185.12,2035,Multifamily,590,583,7,0.011864406779661
185.12,2035,Single Family - Detached,1828,1639,189,0.103391684901532
185.12,2040,Mobile Home,0,0,0,
185.12,2040,Multifamily,590,581,9,0.0152542372881356
185.12,2040,Single Family - Detached,1828,1703,125,0.0683807439824945
185.12,2045,Mobile Home,0,0,0,
185.12,2045,Multifamily,590,580,10,0.0169491525423729
185.12,2045,Single Family - Detached,1828,1696,132,0.0722100656455142
185.12,2050,Mobile Home,0,0,0,
185.12,2050,Multifamily,590,580,10,0.0169491525423729
185.12,2050,Single Family - Detached,1828,1689,139,0.0760393873085339
185.13,2012,Mobile Home,0,0,0,
185.13,2012,Multifamily,1687,1572,115,0.0681683461766449
185.13,2012,Single Family - Detached,1929,1849,80,0.0414722654224987
185.13,2020,Mobile Home,0,0,0,
185.13,2020,Multifamily,1987,1868,119,0.0598892803220936
185.13,2020,Single Family - Detached,2175,2059,116,0.0533333333333333
185.13,2025,Mobile Home,0,0,0,
185.13,2025,Multifamily,1987,1874,113,0.0568696527428284
185.13,2025,Single Family - Detached,2304,2238,66,0.0286458333333333
185.13,2030,Mobile Home,0,0,0,
185.13,2030,Multifamily,1987,1874,113,0.0568696527428284
185.13,2030,Single Family - Detached,2391,2324,67,0.028021748222501
185.13,2035,Mobile Home,0,0,0,
185.13,2035,Multifamily,1987,1878,109,0.0548565676899849
185.13,2035,Single Family - Detached,2406,2350,56,0.0232751454696592
185.13,2040,Mobile Home,0,0,0,
185.13,2040,Multifamily,1987,1875,112,0.0563663814796175
185.13,2040,Single Family - Detached,2493,2473,20,0.00802246289610911
185.13,2045,Mobile Home,0,0,0,
185.13,2045,Multifamily,1987,1874,113,0.0568696527428284
185.13,2045,Single Family - Detached,2548,2521,27,0.010596546310832
185.13,2050,Mobile Home,0,0,0,
185.13,2050,Multifamily,1987,1873,114,0.0573729240060393
185.13,2050,Single Family - Detached,2567,2533,34,0.0132450331125828
185.14,2012,Mobile Home,0,0,0,
185.14,2012,Multifamily,719,670,49,0.0681502086230876
185.14,2012,Single Family - Detached,2290,2208,82,0.0358078602620087
185.14,2020,Mobile Home,0,0,0,
185.14,2020,Multifamily,719,670,49,0.0681502086230876
185.14,2020,Single Family - Detached,2290,2190,100,0.0436681222707424
185.14,2025,Mobile Home,0,0,0,
185.14,2025,Multifamily,719,672,47,0.0653685674547983
185.14,2025,Single Family - Detached,2290,2216,74,0.0323144104803493
185.14,2030,Mobile Home,0,0,0,
185.14,2030,Multifamily,719,672,47,0.0653685674547983
185.14,2030,Single Family - Detached,2290,2212,78,0.034061135371179
185.14,2035,Mobile Home,0,0,0,
185.14,2035,Multifamily,719,673,46,0.0639777468706537
185.14,2035,Single Family - Detached,2290,2219,71,0.0310043668122271
185.14,2040,Mobile Home,0,0,0,
185.14,2040,Multifamily,719,673,46,0.0639777468706537
185.14,2040,Single Family - Detached,2290,2244,46,0.0200873362445415
185.14,2045,Mobile Home,0,0,0,
185.14,2045,Multifamily,719,673,46,0.0639777468706537
185.14,2045,Single Family - Detached,2290,2230,60,0.0262008733624454
185.14,2050,Mobile Home,0,0,0,
185.14,2050,Multifamily,719,673,46,0.0639777468706537
185.14,2050,Single Family - Detached,2292,2261,31,0.0135253054101222
185.15,2012,Mobile Home,0,0,0,
185.15,2012,Multifamily,870,814,56,0.064367816091954
185.15,2012,Single Family - Detached,1362,1280,82,0.0602055800293686
185.15,2020,Mobile Home,0,0,0,
185.15,2020,Multifamily,870,815,55,0.0632183908045977
185.15,2020,Single Family - Detached,1363,1275,88,0.0645634629493764
185.15,2025,Mobile Home,0,0,0,
185.15,2025,Multifamily,870,816,54,0.0620689655172414
185.15,2025,Single Family - Detached,1365,1289,76,0.0556776556776557
185.15,2030,Mobile Home,0,0,0,
185.15,2030,Multifamily,870,816,54,0.0620689655172414
185.15,2030,Single Family - Detached,1366,1287,79,0.0578330893118594
185.15,2035,Mobile Home,0,0,0,
185.15,2035,Multifamily,870,817,53,0.0609195402298851
185.15,2035,Single Family - Detached,1367,1293,74,0.0541331382589612
185.15,2040,Mobile Home,0,0,0,
185.15,2040,Multifamily,870,815,55,0.0632183908045977
185.15,2040,Single Family - Detached,1367,1290,77,0.0563277249451353
185.15,2045,Mobile Home,0,0,0,
185.15,2045,Multifamily,870,814,56,0.064367816091954
185.15,2045,Single Family - Detached,1367,1287,80,0.0585223116313094
185.15,2050,Mobile Home,0,0,0,
185.15,2050,Multifamily,870,813,57,0.0655172413793104
185.15,2050,Single Family - Detached,1367,1287,80,0.0585223116313094
185.16,2012,Mobile Home,0,0,0,
185.16,2012,Multifamily,385,364,21,0.0545454545454545
185.16,2012,Single Family - Detached,930,889,41,0.0440860215053763
185.16,2020,Mobile Home,0,0,0,
185.16,2020,Multifamily,385,366,19,0.0493506493506494
185.16,2020,Single Family - Detached,930,884,46,0.0494623655913978
185.16,2025,Mobile Home,0,0,0,
185.16,2025,Multifamily,385,366,19,0.0493506493506494
185.16,2025,Single Family - Detached,930,895,35,0.0376344086021505
185.16,2030,Mobile Home,0,0,0,
185.16,2030,Multifamily,385,366,19,0.0493506493506494
185.16,2030,Single Family - Detached,930,894,36,0.0387096774193548
185.16,2035,Mobile Home,0,0,0,
185.16,2035,Multifamily,385,366,19,0.0493506493506494
185.16,2035,Single Family - Detached,930,898,32,0.0344086021505376
185.16,2040,Mobile Home,0,0,0,
185.16,2040,Multifamily,385,365,20,0.051948051948052
185.16,2040,Single Family - Detached,930,897,33,0.0354838709677419
185.16,2045,Mobile Home,0,0,0,
185.16,2045,Multifamily,385,365,20,0.051948051948052
185.16,2045,Single Family - Detached,930,896,34,0.0365591397849462
185.16,2050,Mobile Home,0,0,0,
185.16,2050,Multifamily,385,365,20,0.051948051948052
185.16,2050,Single Family - Detached,930,896,34,0.0365591397849462
185.17,2012,Mobile Home,0,0,0,
185.17,2012,Multifamily,852,741,111,0.130281690140845
185.17,2012,Single Family - Detached,1165,1136,29,0.0248927038626609
185.17,2020,Mobile Home,0,0,0,
185.17,2020,Multifamily,852,742,110,0.129107981220657
185.17,2020,Single Family - Detached,1165,1134,31,0.0266094420600858
185.17,2025,Mobile Home,0,0,0,
185.17,2025,Multifamily,852,742,110,0.129107981220657
185.17,2025,Single Family - Detached,1165,1140,25,0.0214592274678112
185.17,2030,Mobile Home,0,0,0,
185.17,2030,Multifamily,852,742,110,0.129107981220657
185.17,2030,Single Family - Detached,1165,1140,25,0.0214592274678112
185.17,2035,Mobile Home,0,0,0,
185.17,2035,Multifamily,852,742,110,0.129107981220657
185.17,2035,Single Family - Detached,1165,1140,25,0.0214592274678112
185.17,2040,Mobile Home,0,0,0,
185.17,2040,Multifamily,852,742,110,0.129107981220657
185.17,2040,Single Family - Detached,1165,1140,25,0.0214592274678112
185.17,2045,Mobile Home,0,0,0,
185.17,2045,Multifamily,852,742,110,0.129107981220657
185.17,2045,Single Family - Detached,1165,1140,25,0.0214592274678112
185.17,2050,Mobile Home,0,0,0,
185.17,2050,Multifamily,852,742,110,0.129107981220657
185.17,2050,Single Family - Detached,1165,1140,25,0.0214592274678112
185.18,2012,Mobile Home,0,0,0,
185.18,2012,Multifamily,170,169,1,0.00588235294117647
185.18,2012,Single Family - Detached,680,656,24,0.0352941176470588
185.18,2020,Mobile Home,0,0,0,
185.18,2020,Multifamily,170,170,0,0
185.18,2020,Single Family - Detached,680,654,26,0.0382352941176471
185.18,2025,Mobile Home,0,0,0,
185.18,2025,Multifamily,170,170,0,0
185.18,2025,Single Family - Detached,680,661,19,0.0279411764705882
185.18,2030,Mobile Home,0,0,0,
185.18,2030,Multifamily,170,170,0,0
185.18,2030,Single Family - Detached,680,661,19,0.0279411764705882
185.18,2035,Mobile Home,0,0,0,
185.18,2035,Multifamily,170,170,0,0
185.18,2035,Single Family - Detached,680,664,16,0.0235294117647059
185.18,2040,Mobile Home,0,0,0,
185.18,2040,Multifamily,170,169,1,0.00588235294117647
185.18,2040,Single Family - Detached,680,664,16,0.0235294117647059
185.18,2045,Mobile Home,0,0,0,
185.18,2045,Multifamily,170,169,1,0.00588235294117647
185.18,2045,Single Family - Detached,680,664,16,0.0235294117647059
185.18,2050,Mobile Home,0,0,0,
185.18,2050,Multifamily,170,169,1,0.00588235294117647
185.18,2050,Single Family - Detached,680,664,16,0.0235294117647059
185.19,2012,Mobile Home,0,0,0,
185.19,2012,Multifamily,462,453,9,0.0194805194805195
185.19,2012,Single Family - Detached,988,935,53,0.0536437246963563
185.19,2020,Mobile Home,0,0,0,
185.19,2020,Multifamily,506,498,8,0.0158102766798419
185.19,2020,Single Family - Detached,1032,973,59,0.0571705426356589
185.19,2025,Mobile Home,0,0,0,
185.19,2025,Multifamily,514,507,7,0.0136186770428016
185.19,2025,Single Family - Detached,1033,988,45,0.0435624394966118
185.19,2030,Mobile Home,0,0,0,
185.19,2030,Multifamily,514,506,8,0.0155642023346304
185.19,2030,Single Family - Detached,1033,988,45,0.0435624394966118
185.19,2035,Mobile Home,0,0,0,
185.19,2035,Multifamily,514,503,11,0.0214007782101167
185.19,2035,Single Family - Detached,1033,993,40,0.0387221684414327
185.19,2040,Mobile Home,0,0,0,
185.19,2040,Multifamily,514,501,13,0.0252918287937743
185.19,2040,Single Family - Detached,1033,988,45,0.0435624394966118
185.19,2045,Mobile Home,0,0,0,
185.19,2045,Multifamily,514,500,14,0.0272373540856031
185.19,2045,Single Family - Detached,1033,987,46,0.0445304937076476
185.19,2050,Mobile Home,0,0,0,
185.19,2050,Multifamily,514,499,15,0.0291828793774319
185.19,2050,Single Family - Detached,1033,987,46,0.0445304937076476
186.01,2012,Mobile Home,56,48,8,0.142857142857143
186.01,2012,Multifamily,1,0,1,1
186.01,2012,Single Family - Detached,1531,1457,74,0.0483344219464402
186.01,2020,Mobile Home,56,44,12,0.214285714285714
186.01,2020,Multifamily,1,0,1,1
186.01,2020,Single Family - Detached,1531,1456,75,0.0489875898105813
186.01,2025,Mobile Home,56,44,12,0.214285714285714
186.01,2025,Multifamily,1,1,0,0
186.01,2025,Single Family - Detached,1531,1460,71,0.046374918354017
186.01,2030,Mobile Home,56,43,13,0.232142857142857
186.01,2030,Multifamily,1,0,1,1
186.01,2030,Single Family - Detached,1531,1460,71,0.046374918354017
186.01,2035,Mobile Home,56,42,14,0.25
186.01,2035,Multifamily,1,0,1,1
186.01,2035,Single Family - Detached,1531,1460,71,0.046374918354017
186.01,2040,Mobile Home,56,37,19,0.339285714285714
186.01,2040,Multifamily,1,1,0,0
186.01,2040,Single Family - Detached,1531,1460,71,0.046374918354017
186.01,2045,Mobile Home,56,36,20,0.357142857142857
186.01,2045,Multifamily,1,0,1,1
186.01,2045,Single Family - Detached,1531,1460,71,0.046374918354017
186.01,2050,Mobile Home,56,34,22,0.392857142857143
186.01,2050,Multifamily,1,0,1,1
186.01,2050,Single Family - Detached,1531,1460,71,0.046374918354017
186.03,2012,Mobile Home,0,0,0,
186.03,2012,Multifamily,1583,1476,107,0.067593177511055
186.03,2012,Single Family - Detached,778,664,114,0.146529562982005
186.03,2020,Mobile Home,0,0,0,
186.03,2020,Multifamily,1585,1458,127,0.0801261829652997
186.03,2020,Single Family - Detached,778,656,122,0.15681233933162
186.03,2025,Mobile Home,0,0,0,
186.03,2025,Multifamily,1594,1484,110,0.06900878293601
186.03,2025,Single Family - Detached,778,671,107,0.137532133676093
186.03,2030,Mobile Home,0,0,0,
186.03,2030,Multifamily,1626,1506,120,0.0738007380073801
186.03,2030,Single Family - Detached,778,671,107,0.137532133676093
186.03,2035,Mobile Home,0,0,0,
186.03,2035,Multifamily,1756,1639,117,0.066628701594533
186.03,2035,Single Family - Detached,778,669,109,0.140102827763496
186.03,2040,Mobile Home,0,0,0,
186.03,2040,Multifamily,1788,1675,113,0.0631991051454139
186.03,2040,Single Family - Detached,778,670,108,0.138817480719794
186.03,2045,Mobile Home,0,0,0,
186.03,2045,Multifamily,1788,1675,113,0.0631991051454139
186.03,2045,Single Family - Detached,778,669,109,0.140102827763496
186.03,2050,Mobile Home,0,0,0,
186.03,2050,Multifamily,1788,1672,116,0.0648769574944072
186.03,2050,Single Family - Detached,778,666,112,0.143958868894602
186.08,2012,Mobile Home,203,202,1,0.00492610837438424
186.08,2012,Multifamily,292,292,0,0
186.08,2012,Single Family - Detached,596,592,4,0.00671140939597315
186.08,2020,Mobile Home,203,203,0,0
186.08,2020,Multifamily,292,291,1,0.00342465753424658
186.08,2020,Single Family - Detached,596,589,7,0.011744966442953
186.08,2025,Mobile Home,203,202,1,0.00492610837438424
186.08,2025,Multifamily,292,292,0,0
186.08,2025,Single Family - Detached,596,594,2,0.00335570469798658
186.08,2030,Mobile Home,203,200,3,0.0147783251231527
186.08,2030,Multifamily,292,292,0,0
186.08,2030,Single Family - Detached,596,592,4,0.00671140939597315
186.08,2035,Mobile Home,203,201,2,0.00985221674876847
186.08,2035,Multifamily,292,292,0,0
186.08,2035,Single Family - Detached,596,595,1,0.00167785234899329
186.08,2040,Mobile Home,203,202,1,0.00492610837438424
186.08,2040,Multifamily,292,292,0,0
186.08,2040,Single Family - Detached,596,596,0,0
186.08,2045,Mobile Home,203,200,3,0.0147783251231527
186.08,2045,Multifamily,292,292,0,0
186.08,2045,Single Family - Detached,596,593,3,0.00503355704697987
186.08,2050,Mobile Home,203,194,9,0.0443349753694581
186.08,2050,Multifamily,292,292,0,0
186.08,2050,Single Family - Detached,596,590,6,0.0100671140939597
186.09,2012,Mobile Home,254,234,20,0.078740157480315
186.09,2012,Multifamily,157,157,0,0
186.09,2012,Single Family - Detached,1426,1353,73,0.0511921458625526
186.09,2020,Mobile Home,254,235,19,0.0748031496062992
186.09,2020,Multifamily,157,154,3,0.0191082802547771
186.09,2020,Single Family - Detached,1426,1338,88,0.061711079943899
186.09,2025,Mobile Home,254,235,19,0.0748031496062992
186.09,2025,Multifamily,157,157,0,0
186.09,2025,Single Family - Detached,1426,1362,64,0.0448807854137447
186.09,2030,Mobile Home,254,233,21,0.0826771653543307
186.09,2030,Multifamily,157,157,0,0
186.09,2030,Single Family - Detached,1426,1354,72,0.0504908835904628
186.09,2035,Mobile Home,254,233,21,0.0826771653543307
186.09,2035,Multifamily,157,157,0,0
186.09,2035,Single Family - Detached,1426,1365,61,0.0427769985974755
186.09,2040,Mobile Home,254,234,20,0.078740157480315
186.09,2040,Multifamily,157,154,3,0.0191082802547771
186.09,2040,Single Family - Detached,1426,1389,37,0.0259467040673212
186.09,2045,Mobile Home,254,233,21,0.0826771653543307
186.09,2045,Multifamily,157,153,4,0.0254777070063694
186.09,2045,Single Family - Detached,1426,1376,50,0.0350631136044881
186.09,2050,Mobile Home,254,228,26,0.102362204724409
186.09,2050,Multifamily,157,151,6,0.0382165605095541
186.09,2050,Single Family - Detached,1426,1364,62,0.0434782608695652
186.10,2012,Mobile Home,0,0,0,
186.10,2012,Multifamily,419,417,2,0.00477326968973747
186.10,2012,Single Family - Detached,1642,1519,123,0.0749086479902558
186.10,2020,Mobile Home,0,0,0,
186.10,2020,Multifamily,419,416,3,0.00715990453460621
186.10,2020,Single Family - Detached,1642,1505,137,0.0834348355663825
186.10,2025,Mobile Home,0,0,0,
186.10,2025,Multifamily,523,521,2,0.00382409177820268
186.10,2025,Single Family - Detached,1642,1532,110,0.0669914738124239
186.10,2030,Mobile Home,0,0,0,
186.10,2030,Multifamily,528,527,1,0.00189393939393939
186.10,2030,Single Family - Detached,1642,1526,116,0.0706455542021924
186.10,2035,Mobile Home,0,0,0,
186.10,2035,Multifamily,532,532,0,0
186.10,2035,Single Family - Detached,1642,1538,104,0.0633373934226553
186.10,2040,Mobile Home,0,0,0,
186.10,2040,Multifamily,532,532,0,0
186.10,2040,Single Family - Detached,1642,1576,66,0.0401948842874543
186.10,2045,Mobile Home,0,0,0,
186.10,2045,Multifamily,532,532,0,0
186.10,2045,Single Family - Detached,1642,1565,77,0.0468940316686967
186.10,2050,Mobile Home,0,0,0,
186.10,2050,Multifamily,532,532,0,0
186.10,2050,Single Family - Detached,1642,1555,87,0.0529841656516443
186.11,2012,Mobile Home,0,0,0,
186.11,2012,Multifamily,196,196,0,0
186.11,2012,Single Family - Detached,2326,2252,74,0.0318142734307825
186.11,2020,Mobile Home,0,0,0,
186.11,2020,Multifamily,196,196,0,0
186.11,2020,Single Family - Detached,2556,2457,99,0.0387323943661972
186.11,2025,Mobile Home,0,0,0,
186.11,2025,Multifamily,196,196,0,0
186.11,2025,Single Family - Detached,2560,2501,59,0.023046875
186.11,2030,Mobile Home,0,0,0,
186.11,2030,Multifamily,196,196,0,0
186.11,2030,Single Family - Detached,2560,2492,68,0.0265625
186.11,2035,Mobile Home,0,0,0,
186.11,2035,Multifamily,196,196,0,0
186.11,2035,Single Family - Detached,2560,2494,66,0.02578125
186.11,2040,Mobile Home,0,0,0,
186.11,2040,Multifamily,196,196,0,0
186.11,2040,Single Family - Detached,2560,2465,95,0.037109375
186.11,2045,Mobile Home,0,0,0,
186.11,2045,Multifamily,196,196,0,0
186.11,2045,Single Family - Detached,2560,2441,119,0.046484375
186.11,2050,Mobile Home,0,0,0,
186.11,2050,Multifamily,196,196,0,0
186.11,2050,Single Family - Detached,2560,2429,131,0.051171875
186.12,2012,Mobile Home,0,0,0,
186.12,2012,Multifamily,59,55,4,0.0677966101694915
186.12,2012,Single Family - Detached,1060,974,86,0.0811320754716981
186.12,2020,Mobile Home,0,0,0,
186.12,2020,Multifamily,165,163,2,0.0121212121212121
186.12,2020,Single Family - Detached,1155,1061,94,0.0813852813852814
186.12,2025,Mobile Home,0,0,0,
186.12,2025,Multifamily,165,164,1,0.00606060606060606
186.12,2025,Single Family - Detached,1155,1070,85,0.0735930735930736
186.12,2030,Mobile Home,0,0,0,
186.12,2030,Multifamily,165,164,1,0.00606060606060606
186.12,2030,Single Family - Detached,1155,1065,90,0.0779220779220779
186.12,2035,Mobile Home,0,0,0,
186.12,2035,Multifamily,165,165,0,0
186.12,2035,Single Family - Detached,1155,1071,84,0.0727272727272727
186.12,2040,Mobile Home,0,0,0,
186.12,2040,Multifamily,165,163,2,0.0121212121212121
186.12,2040,Single Family - Detached,1155,1069,86,0.0744588744588745
186.12,2045,Mobile Home,0,0,0,
186.12,2045,Multifamily,165,163,2,0.0121212121212121
186.12,2045,Single Family - Detached,1155,1068,87,0.0753246753246753
186.12,2050,Mobile Home,0,0,0,
186.12,2050,Multifamily,165,162,3,0.0181818181818182
186.12,2050,Single Family - Detached,1155,1067,88,0.0761904761904762
186.13,2012,Mobile Home,0,0,0,
186.13,2012,Multifamily,681,672,9,0.013215859030837
186.13,2012,Single Family - Detached,610,519,91,0.149180327868852
186.13,2020,Mobile Home,0,0,0,
186.13,2020,Multifamily,681,670,11,0.0161527165932452
186.13,2020,Single Family - Detached,610,512,98,0.160655737704918
186.13,2025,Mobile Home,0,0,0,
186.13,2025,Multifamily,681,672,9,0.013215859030837
186.13,2025,Single Family - Detached,610,527,83,0.136065573770492
186.13,2030,Mobile Home,0,0,0,
186.13,2030,Multifamily,681,672,9,0.013215859030837
186.13,2030,Single Family - Detached,610,526,84,0.137704918032787
186.13,2035,Mobile Home,0,0,0,
186.13,2035,Multifamily,681,673,8,0.0117474302496329
186.13,2035,Single Family - Detached,610,532,78,0.127868852459016
186.13,2040,Mobile Home,0,0,0,
186.13,2040,Multifamily,681,672,9,0.013215859030837
186.13,2040,Single Family - Detached,610,559,51,0.0836065573770492
186.13,2045,Mobile Home,0,0,0,
186.13,2045,Multifamily,681,672,9,0.013215859030837
186.13,2045,Single Family - Detached,610,553,57,0.0934426229508197
186.13,2050,Mobile Home,0,0,0,
186.13,2050,Multifamily,681,672,9,0.013215859030837
186.13,2050,Single Family - Detached,610,547,63,0.10327868852459
186.14,2012,Mobile Home,996,989,7,0.0070281124497992
186.14,2012,Multifamily,1090,1063,27,0.0247706422018349
186.14,2012,Single Family - Detached,572,353,219,0.382867132867133
186.14,2020,Mobile Home,996,992,4,0.00401606425702811
186.14,2020,Multifamily,1090,1061,29,0.026605504587156
186.14,2020,Single Family - Detached,572,348,224,0.391608391608392
186.14,2025,Mobile Home,996,992,4,0.00401606425702811
186.14,2025,Multifamily,1090,1066,24,0.0220183486238532
186.14,2025,Single Family - Detached,572,357,215,0.375874125874126
186.14,2030,Mobile Home,996,988,8,0.00803212851405622
186.14,2030,Multifamily,1090,1065,25,0.0229357798165138
186.14,2030,Single Family - Detached,572,356,216,0.377622377622378
186.14,2035,Mobile Home,996,988,8,0.00803212851405622
186.14,2035,Multifamily,1090,1067,23,0.0211009174311927
186.14,2035,Single Family - Detached,572,360,212,0.370629370629371
186.14,2040,Mobile Home,996,989,7,0.0070281124497992
186.14,2040,Multifamily,1090,1064,26,0.0238532110091743
186.14,2040,Single Family - Detached,572,387,185,0.323426573426573
186.14,2045,Mobile Home,996,986,10,0.0100401606425703
186.14,2045,Multifamily,1090,1064,26,0.0238532110091743
186.14,2045,Single Family - Detached,572,385,187,0.326923076923077
186.14,2050,Mobile Home,996,970,26,0.0261044176706827
186.14,2050,Multifamily,1090,1064,26,0.0238532110091743
186.14,2050,Single Family - Detached,572,384,188,0.328671328671329
187,2012,Mobile Home,0,0,0,
187,2012,Multifamily,675,598,77,0.114074074074074
187,2012,Single Family - Detached,6563,5533,1030,0.156940423586774
187,2020,Mobile Home,0,0,0,
187,2020,Multifamily,2342,2068,274,0.116994022203245
187,2020,Single Family - Detached,6563,5528,1035,0.157702270303215
187,2025,Mobile Home,0,0,0,
187,2025,Multifamily,2342,2070,272,0.116140051238258
187,2025,Single Family - Detached,6563,5534,1029,0.156788054243486
187,2030,Mobile Home,0,0,0,
187,2030,Multifamily,2342,2070,272,0.116140051238258
187,2030,Single Family - Detached,6563,5533,1030,0.156940423586774
187,2035,Mobile Home,0,0,0,
187,2035,Multifamily,2342,2072,270,0.115286080273271
187,2035,Single Family - Detached,6563,5537,1026,0.156330946213622
187,2040,Mobile Home,0,0,0,
187,2040,Multifamily,2342,2067,275,0.117421007685739
187,2040,Single Family - Detached,6563,5529,1034,0.157549900959927
187,2045,Mobile Home,0,0,0,
187,2045,Multifamily,2342,2066,276,0.117847993168232
187,2045,Single Family - Detached,6563,5524,1039,0.158311747676368
187,2050,Mobile Home,0,0,0,
187,2050,Multifamily,2342,2065,277,0.118274978650726
187,2050,Single Family - Detached,6563,5525,1038,0.158159378333079
188.01,2012,Mobile Home,0,0,0,
188.01,2012,Multifamily,0,0,0,
188.01,2012,Single Family - Detached,1383,1320,63,0.0455531453362256
188.01,2020,Mobile Home,0,0,0,
188.01,2020,Multifamily,0,0,0,
188.01,2020,Single Family - Detached,1639,1536,103,0.062843197071385
188.01,2025,Mobile Home,0,0,0,
188.01,2025,Multifamily,0,0,0,
188.01,2025,Single Family - Detached,1758,1682,76,0.043230944254835
188.01,2030,Mobile Home,0,0,0,
188.01,2030,Multifamily,0,0,0,
188.01,2030,Single Family - Detached,1889,1809,80,0.042350449973531
188.01,2035,Mobile Home,0,0,0,
188.01,2035,Multifamily,0,0,0,
188.01,2035,Single Family - Detached,1889,1806,83,0.0439385918475384
188.01,2040,Mobile Home,0,0,0,
188.01,2040,Multifamily,0,0,0,
188.01,2040,Single Family - Detached,1889,1798,91,0.0481736368448915
188.01,2045,Mobile Home,0,0,0,
188.01,2045,Multifamily,0,0,0,
188.01,2045,Single Family - Detached,1889,1789,100,0.0529380624669137
188.01,2050,Mobile Home,0,0,0,
188.01,2050,Multifamily,0,0,0,
188.01,2050,Single Family - Detached,1889,1788,101,0.0534674430915828
188.02,2012,Mobile Home,108,108,0,0
188.02,2012,Multifamily,11,7,4,0.363636363636364
188.02,2012,Single Family - Detached,3416,3201,215,0.0629391100702576
188.02,2020,Mobile Home,108,108,0,0
188.02,2020,Multifamily,11,11,0,0
188.02,2020,Single Family - Detached,3559,3327,232,0.0651868502388311
188.02,2025,Mobile Home,108,108,0,0
188.02,2025,Multifamily,11,11,0,0
188.02,2025,Single Family - Detached,3578,3369,209,0.058412520961431
188.02,2030,Mobile Home,108,107,1,0.00925925925925926
188.02,2030,Multifamily,11,11,0,0
188.02,2030,Single Family - Detached,3846,3615,231,0.0600624024960998
188.02,2035,Mobile Home,108,107,1,0.00925925925925926
188.02,2035,Multifamily,11,11,0,0
188.02,2035,Single Family - Detached,4219,3998,221,0.052382081061863
188.02,2040,Mobile Home,108,108,0,0
188.02,2040,Multifamily,11,11,0,0
188.02,2040,Single Family - Detached,4255,4019,236,0.0554641598119859
188.02,2045,Mobile Home,108,107,1,0.00925925925925926
188.02,2045,Multifamily,11,11,0,0
188.02,2045,Single Family - Detached,4277,4017,260,0.060790273556231
188.02,2050,Mobile Home,108,103,5,0.0462962962962963
188.02,2050,Multifamily,11,11,0,0
188.02,2050,Single Family - Detached,4277,4008,269,0.0628945522562544
188.03,2012,Mobile Home,230,230,0,0
188.03,2012,Multifamily,309,307,2,0.00647249190938511
188.03,2012,Single Family - Detached,1407,1319,88,0.062544420753376
188.03,2020,Mobile Home,230,230,0,0
188.03,2020,Multifamily,309,309,0,0
188.03,2020,Single Family - Detached,1736,1624,112,0.0645161290322581
188.03,2025,Mobile Home,230,230,0,0
188.03,2025,Multifamily,309,309,0,0
188.03,2025,Single Family - Detached,1909,1808,101,0.0529072812991095
188.03,2030,Mobile Home,230,229,1,0.00434782608695652
188.03,2030,Multifamily,309,309,0,0
188.03,2030,Single Family - Detached,2037,1932,105,0.0515463917525773
188.03,2035,Mobile Home,230,229,1,0.00434782608695652
188.03,2035,Multifamily,309,309,0,0
188.03,2035,Single Family - Detached,2330,2228,102,0.0437768240343348
188.03,2040,Mobile Home,230,229,1,0.00434782608695652
188.03,2040,Multifamily,309,309,0,0
188.03,2040,Single Family - Detached,2374,2261,113,0.0475989890480202
188.03,2045,Mobile Home,230,228,2,0.00869565217391304
188.03,2045,Multifamily,309,309,0,0
188.03,2045,Single Family - Detached,2414,2290,124,0.0513670256835128
188.03,2050,Mobile Home,230,225,5,0.0217391304347826
188.03,2050,Multifamily,309,309,0,0
188.03,2050,Single Family - Detached,2418,2289,129,0.0533498759305211
189.03,2012,Mobile Home,129,123,6,0.0465116279069767
189.03,2012,Multifamily,384,364,20,0.0520833333333333
189.03,2012,Single Family - Detached,1205,1181,24,0.0199170124481328
189.03,2020,Mobile Home,129,123,6,0.0465116279069767
189.03,2020,Multifamily,384,352,32,0.0833333333333333
189.03,2020,Single Family - Detached,1214,1175,39,0.0321252059308072
189.03,2025,Mobile Home,129,123,6,0.0465116279069767
189.03,2025,Multifamily,384,353,31,0.0807291666666667
189.03,2025,Single Family - Detached,1218,1192,26,0.0213464696223317
189.03,2030,Mobile Home,129,124,5,0.0387596899224806
189.03,2030,Multifamily,384,353,31,0.0807291666666667
189.03,2030,Single Family - Detached,1231,1211,20,0.016246953696182
189.03,2035,Mobile Home,129,124,5,0.0387596899224806
189.03,2035,Multifamily,384,354,30,0.078125
189.03,2035,Single Family - Detached,1264,1247,17,0.0134493670886076
189.03,2040,Mobile Home,129,125,4,0.0310077519379845
189.03,2040,Multifamily,384,353,31,0.0807291666666667
189.03,2040,Single Family - Detached,1281,1260,21,0.0163934426229508
189.03,2045,Mobile Home,129,124,5,0.0387596899224806
189.03,2045,Multifamily,394,352,42,0.106598984771574
189.03,2045,Single Family - Detached,1299,1262,37,0.0284834488067744
189.03,2050,Mobile Home,118,111,7,0.0593220338983051
189.03,2050,Multifamily,382,336,46,0.120418848167539
189.03,2050,Single Family - Detached,1310,1254,56,0.0427480916030534
189.04,2012,Mobile Home,0,0,0,
189.04,2012,Multifamily,817,758,59,0.0722154222766218
189.04,2012,Single Family - Detached,1153,1099,54,0.0468343451864701
189.04,2020,Mobile Home,0,0,0,
189.04,2020,Multifamily,735,665,70,0.0952380952380952
189.04,2020,Single Family - Detached,1150,1062,88,0.0765217391304348
189.04,2025,Mobile Home,0,0,0,
189.04,2025,Multifamily,735,681,54,0.073469387755102
189.04,2025,Single Family - Detached,1147,1083,64,0.0557977332170881
189.04,2030,Mobile Home,0,0,0,
189.04,2030,Multifamily,735,681,54,0.073469387755102
189.04,2030,Single Family - Detached,1193,1108,85,0.0712489522212909
189.04,2035,Mobile Home,0,0,0,
189.04,2035,Multifamily,735,687,48,0.0653061224489796
189.04,2035,Single Family - Detached,1206,1129,77,0.0638474295190713
189.04,2040,Mobile Home,0,0,0,
189.04,2040,Multifamily,799,736,63,0.0788485607008761
189.04,2040,Single Family - Detached,1197,1105,92,0.076858813700919
189.04,2045,Mobile Home,0,0,0,
189.04,2045,Multifamily,932,859,73,0.0783261802575107
189.04,2045,Single Family - Detached,1179,1080,99,0.083969465648855
189.04,2050,Mobile Home,0,0,0,
189.04,2050,Multifamily,925,851,74,0.08
189.04,2050,Single Family - Detached,1182,1097,85,0.071912013536379
189.05,2012,Mobile Home,77,74,3,0.038961038961039
189.05,2012,Multifamily,813,746,67,0.0824108241082411
189.05,2012,Single Family - Detached,1178,1144,34,0.0288624787775891
189.05,2020,Mobile Home,40,40,0,0
189.05,2020,Multifamily,991,927,64,0.0645812310797175
189.05,2020,Single Family - Detached,1186,1149,37,0.0311973018549747
189.05,2025,Mobile Home,40,40,0,0
189.05,2025,Multifamily,996,937,59,0.0592369477911647
189.05,2025,Single Family - Detached,1238,1200,38,0.0306946688206785
189.05,2030,Mobile Home,0,0,0,
189.05,2030,Multifamily,1003,943,60,0.0598205383848455
189.05,2030,Single Family - Detached,1278,1235,43,0.0336463223787167
189.05,2035,Mobile Home,0,0,0,
189.05,2035,Multifamily,1010,951,59,0.0584158415841584
189.05,2035,Single Family - Detached,1356,1313,43,0.0317109144542773
189.05,2040,Mobile Home,0,0,0,
189.05,2040,Multifamily,1078,1011,67,0.062152133580705
189.05,2040,Single Family - Detached,1400,1357,43,0.0307142857142857
189.05,2045,Mobile Home,0,0,0,
189.05,2045,Multifamily,1120,1052,68,0.0607142857142857
189.05,2045,Single Family - Detached,1470,1426,44,0.0299319727891156
189.05,2050,Mobile Home,0,0,0,
189.05,2050,Multifamily,1120,1052,68,0.0607142857142857
189.05,2050,Single Family - Detached,1492,1446,46,0.0308310991957105
189.06,2012,Mobile Home,273,226,47,0.172161172161172
189.06,2012,Multifamily,794,756,38,0.0478589420654912
189.06,2012,Single Family - Detached,1089,1016,73,0.0670339761248852
189.06,2020,Mobile Home,273,226,47,0.172161172161172
189.06,2020,Multifamily,699,678,21,0.0300429184549356
189.06,2020,Single Family - Detached,1345,1295,50,0.0371747211895911
189.06,2025,Mobile Home,273,226,47,0.172161172161172
189.06,2025,Multifamily,699,679,20,0.0286123032904149
189.06,2025,Single Family - Detached,1419,1371,48,0.0338266384778013
189.06,2030,Mobile Home,273,229,44,0.161172161172161
189.06,2030,Multifamily,699,678,21,0.0300429184549356
189.06,2030,Single Family - Detached,1489,1451,38,0.025520483546004
189.06,2035,Mobile Home,273,229,44,0.161172161172161
189.06,2035,Multifamily,699,679,20,0.0286123032904149
189.06,2035,Single Family - Detached,1510,1472,38,0.0251655629139073
189.06,2040,Mobile Home,225,189,36,0.16
189.06,2040,Multifamily,846,822,24,0.0283687943262411
189.06,2040,Single Family - Detached,1502,1464,38,0.0252996005326232
189.06,2045,Mobile Home,225,189,36,0.16
189.06,2045,Multifamily,871,845,26,0.0298507462686567
189.06,2045,Single Family - Detached,1497,1460,37,0.0247160988643955
189.06,2050,Mobile Home,225,187,38,0.168888888888889
189.06,2050,Multifamily,871,845,26,0.0298507462686567
189.06,2050,Single Family - Detached,1497,1459,38,0.0253841015364061
19,2012,Mobile Home,0,0,0,
19,2012,Multifamily,190,189,1,0.00526315789473684
19,2012,Single Family - Detached,1323,1285,38,0.0287226001511716
19,2020,Mobile Home,0,0,0,
19,2020,Multifamily,190,183,7,0.0368421052631579
19,2020,Single Family - Detached,1340,1303,37,0.0276119402985075
19,2025,Mobile Home,0,0,0,
19,2025,Multifamily,190,177,13,0.068421052631579
19,2025,Single Family - Detached,1340,1306,34,0.0253731343283582
19,2030,Mobile Home,0,0,0,
19,2030,Multifamily,210,193,17,0.080952380952381
19,2030,Single Family - Detached,1332,1298,34,0.0255255255255255
19,2035,Mobile Home,0,0,0,
19,2035,Multifamily,225,204,21,0.0933333333333333
19,2035,Single Family - Detached,1330,1294,36,0.0270676691729323
19,2040,Mobile Home,0,0,0,
19,2040,Multifamily,225,199,26,0.115555555555556
19,2040,Single Family - Detached,1330,1291,39,0.0293233082706767
19,2045,Mobile Home,0,0,0,
19,2045,Multifamily,225,196,29,0.128888888888889
19,2045,Single Family - Detached,1333,1291,42,0.0315078769692423
19,2050,Mobile Home,0,0,0,
19,2050,Multifamily,225,195,30,0.133333333333333
19,2050,Single Family - Detached,1333,1289,44,0.0330082520630158
190.01,2012,Mobile Home,105,105,0,0
190.01,2012,Multifamily,1,0,1,1
190.01,2012,Single Family - Detached,2262,2224,38,0.0167992926613616
190.01,2020,Mobile Home,105,105,0,0
190.01,2020,Multifamily,1,1,0,0
190.01,2020,Single Family - Detached,2424,2384,40,0.0165016501650165
190.01,2025,Mobile Home,105,105,0,0
190.01,2025,Multifamily,1,1,0,0
190.01,2025,Single Family - Detached,2652,2636,16,0.00603318250377074
190.01,2030,Mobile Home,105,105,0,0
190.01,2030,Multifamily,1,0,1,1
190.01,2030,Single Family - Detached,2843,2828,15,0.00527611677805135
190.01,2035,Mobile Home,105,105,0,0
190.01,2035,Multifamily,1,1,0,0
190.01,2035,Single Family - Detached,2991,2975,16,0.00534938147776663
190.01,2040,Mobile Home,105,105,0,0
190.01,2040,Multifamily,1,0,1,1
190.01,2040,Single Family - Detached,3055,3035,20,0.00654664484451719
190.01,2045,Mobile Home,105,105,0,0
190.01,2045,Multifamily,1,0,1,1
190.01,2045,Single Family - Detached,3113,3092,21,0.00674590427240604
190.01,2050,Mobile Home,105,104,1,0.00952380952380952
190.01,2050,Multifamily,1,0,1,1
190.01,2050,Single Family - Detached,3119,3099,20,0.00641231163834562
190.02,2012,Mobile Home,7,7,0,0
190.02,2012,Multifamily,0,0,0,
190.02,2012,Single Family - Detached,552,552,0,0
190.02,2020,Mobile Home,7,7,0,0
190.02,2020,Multifamily,0,0,0,
190.02,2020,Single Family - Detached,1334,1318,16,0.0119940029985007
190.02,2025,Mobile Home,7,7,0,0
190.02,2025,Multifamily,0,0,0,
190.02,2025,Single Family - Detached,1342,1317,25,0.018628912071535
190.02,2030,Mobile Home,7,6,1,0.142857142857143
190.02,2030,Multifamily,0,0,0,
190.02,2030,Single Family - Detached,1489,1460,29,0.0194761584956347
190.02,2035,Mobile Home,7,6,1,0.142857142857143
190.02,2035,Multifamily,0,0,0,
190.02,2035,Single Family - Detached,2083,2053,30,0.014402304368699
190.02,2040,Mobile Home,7,6,1,0.142857142857143
190.02,2040,Multifamily,0,0,0,
190.02,2040,Single Family - Detached,2121,2085,36,0.016973125884017
190.02,2045,Mobile Home,7,5,2,0.285714285714286
190.02,2045,Multifamily,0,0,0,
190.02,2045,Single Family - Detached,2147,2104,43,0.0200279459711225
190.02,2050,Mobile Home,7,4,3,0.428571428571429
190.02,2050,Multifamily,0,0,0,
190.02,2050,Single Family - Detached,2156,2112,44,0.0204081632653061
191.01,2012,Mobile Home,139,93,46,0.330935251798561
191.01,2012,Multifamily,10,10,0,0
191.01,2012,Single Family - Detached,2404,2399,5,0.00207986688851913
191.01,2020,Mobile Home,139,94,45,0.323741007194245
191.01,2020,Multifamily,10,10,0,0
191.01,2020,Single Family - Detached,2683,2673,10,0.00372717107715244
191.01,2025,Mobile Home,139,94,45,0.323741007194245
191.01,2025,Multifamily,10,10,0,0
191.01,2025,Single Family - Detached,2737,2729,8,0.00292290829375228
191.01,2030,Mobile Home,139,93,46,0.330935251798561
191.01,2030,Multifamily,10,10,0,0
191.01,2030,Single Family - Detached,2813,2804,9,0.00319943121222894
191.01,2035,Mobile Home,139,93,46,0.330935251798561
191.01,2035,Multifamily,10,10,0,0
191.01,2035,Single Family - Detached,3001,2993,8,0.00266577807397534
191.01,2040,Mobile Home,139,93,46,0.330935251798561
191.01,2040,Multifamily,10,10,0,0
191.01,2040,Single Family - Detached,3074,3057,17,0.005530253741054
191.01,2045,Mobile Home,139,93,46,0.330935251798561
191.01,2045,Multifamily,10,10,0,0
191.01,2045,Single Family - Detached,3125,3100,25,0.008
191.01,2050,Mobile Home,139,91,48,0.345323741007194
191.01,2050,Multifamily,10,10,0,0
191.01,2050,Single Family - Detached,3130,3103,27,0.00862619808306709
191.03,2012,Mobile Home,267,267,0,0
191.03,2012,Multifamily,18,9,9,0.5
191.03,2012,Single Family - Detached,1996,1948,48,0.0240480961923848
191.03,2020,Mobile Home,267,267,0,0
191.03,2020,Multifamily,18,15,3,0.166666666666667
191.03,2020,Single Family - Detached,2543,2477,66,0.0259535981124656
191.03,2025,Mobile Home,267,267,0,0
191.03,2025,Multifamily,18,16,2,0.111111111111111
191.03,2025,Single Family - Detached,2628,2574,54,0.0205479452054795
191.03,2030,Mobile Home,267,265,2,0.00749063670411985
191.03,2030,Multifamily,18,16,2,0.111111111111111
191.03,2030,Single Family - Detached,2736,2679,57,0.0208333333333333
191.03,2035,Mobile Home,267,265,2,0.00749063670411985
191.03,2035,Multifamily,18,17,1,0.0555555555555556
191.03,2035,Single Family - Detached,2863,2809,54,0.0188613342647572
191.03,2040,Mobile Home,267,266,1,0.00374531835205993
191.03,2040,Multifamily,19,18,1,0.0526315789473684
191.03,2040,Single Family - Detached,2902,2843,59,0.0203308063404549
191.03,2045,Mobile Home,267,265,2,0.00749063670411985
191.03,2045,Multifamily,19,18,1,0.0526315789473684
191.03,2045,Single Family - Detached,2943,2878,65,0.0220863064899762
191.03,2050,Mobile Home,267,260,7,0.0262172284644195
191.03,2050,Multifamily,19,18,1,0.0526315789473684
191.03,2050,Single Family - Detached,2944,2878,66,0.0224184782608696
191.05,2012,Mobile Home,561,290,271,0.483065953654189
191.05,2012,Multifamily,68,68,0,0
191.05,2012,Single Family - Detached,2043,1890,153,0.0748898678414097
191.05,2020,Mobile Home,561,290,271,0.483065953654189
191.05,2020,Multifamily,68,68,0,0
191.05,2020,Single Family - Detached,2420,2257,163,0.0673553719008265
191.05,2025,Mobile Home,561,290,271,0.483065953654189
191.05,2025,Multifamily,68,68,0,0
191.05,2025,Single Family - Detached,2493,2343,150,0.0601684717208183
191.05,2030,Mobile Home,561,289,272,0.484848484848485
191.05,2030,Multifamily,68,68,0,0
191.05,2030,Single Family - Detached,2659,2502,157,0.059044753666792
191.05,2035,Mobile Home,561,289,272,0.484848484848485
191.05,2035,Multifamily,68,68,0,0
191.05,2035,Single Family - Detached,2861,2720,141,0.0492834673191192
191.05,2040,Mobile Home,561,289,272,0.484848484848485
191.05,2040,Multifamily,120,120,0,0
191.05,2040,Single Family - Detached,2960,2812,148,0.05
191.05,2045,Mobile Home,561,289,272,0.484848484848485
191.05,2045,Multifamily,615,615,0,0
191.05,2045,Single Family - Detached,3031,2896,135,0.0445397558561531
191.05,2050,Mobile Home,561,285,276,0.491978609625668
191.05,2050,Multifamily,615,615,0,0
191.05,2050,Single Family - Detached,3035,2900,135,0.0444810543657331
191.06,2012,Mobile Home,128,124,4,0.03125
191.06,2012,Multifamily,2,0,2,1
191.06,2012,Single Family - Detached,2875,2812,63,0.0219130434782609
191.06,2020,Mobile Home,109,106,3,0.0275229357798165
191.06,2020,Multifamily,2,2,0,0
191.06,2020,Single Family - Detached,3141,3071,70,0.0222858962113976
191.06,2025,Mobile Home,109,106,3,0.0275229357798165
191.06,2025,Multifamily,2,2,0,0
191.06,2025,Single Family - Detached,3235,3171,64,0.0197836166924266
191.06,2030,Mobile Home,109,104,5,0.0458715596330275
191.06,2030,Multifamily,2,0,2,1
191.06,2030,Single Family - Detached,3350,3284,66,0.0197014925373134
191.06,2035,Mobile Home,109,104,5,0.0458715596330275
191.06,2035,Multifamily,2,2,0,0
191.06,2035,Single Family - Detached,3510,3437,73,0.0207977207977208
191.06,2040,Mobile Home,109,105,4,0.036697247706422
191.06,2040,Multifamily,2,0,2,1
191.06,2040,Single Family - Detached,3558,3481,77,0.0216413715570545
191.06,2045,Mobile Home,109,104,5,0.0458715596330275
191.06,2045,Multifamily,2,0,2,1
191.06,2045,Single Family - Detached,3604,3520,84,0.02330743618202
191.06,2050,Mobile Home,109,98,11,0.100917431192661
191.06,2050,Multifamily,2,0,2,1
191.06,2050,Single Family - Detached,3607,3519,88,0.0243970058220128
191.07,2012,Mobile Home,220,220,0,0
191.07,2012,Multifamily,0,0,0,
191.07,2012,Single Family - Detached,595,555,40,0.0672268907563025
191.07,2020,Mobile Home,220,220,0,0
191.07,2020,Multifamily,0,0,0,
191.07,2020,Single Family - Detached,625,568,57,0.0912
191.07,2025,Mobile Home,220,220,0,0
191.07,2025,Multifamily,0,0,0,
191.07,2025,Single Family - Detached,638,597,41,0.0642633228840125
191.07,2030,Mobile Home,220,220,0,0
191.07,2030,Multifamily,0,0,0,
191.07,2030,Single Family - Detached,650,606,44,0.0676923076923077
191.07,2035,Mobile Home,220,220,0,0
191.07,2035,Multifamily,0,0,0,
191.07,2035,Single Family - Detached,688,652,36,0.0523255813953488
191.07,2040,Mobile Home,220,220,0,0
191.07,2040,Multifamily,0,0,0,
191.07,2040,Single Family - Detached,688,650,38,0.0552325581395349
191.07,2045,Mobile Home,220,220,0,0
191.07,2045,Multifamily,0,0,0,
191.07,2045,Single Family - Detached,694,650,44,0.0634005763688761
191.07,2050,Mobile Home,220,219,1,0.00454545454545455
191.07,2050,Multifamily,0,0,0,
191.07,2050,Single Family - Detached,695,651,44,0.0633093525179856
192.03,2012,Mobile Home,28,22,6,0.214285714285714
192.03,2012,Multifamily,40,40,0,0
192.03,2012,Single Family - Detached,899,887,12,0.0133481646273637
192.03,2020,Mobile Home,28,23,5,0.178571428571429
192.03,2020,Multifamily,40,40,0,0
192.03,2020,Single Family - Detached,985,970,15,0.0152284263959391
192.03,2025,Mobile Home,28,22,6,0.214285714285714
192.03,2025,Multifamily,40,40,0,0
192.03,2025,Single Family - Detached,989,978,11,0.0111223458038423
192.03,2030,Mobile Home,28,22,6,0.214285714285714
192.03,2030,Multifamily,41,41,0,0
192.03,2030,Single Family - Detached,989,976,13,0.0131445904954499
192.03,2035,Mobile Home,28,23,5,0.178571428571429
192.03,2035,Multifamily,44,44,0,0
192.03,2035,Single Family - Detached,989,978,11,0.0111223458038423
192.03,2040,Mobile Home,28,23,5,0.178571428571429
192.03,2040,Multifamily,92,92,0,0
192.03,2040,Single Family - Detached,989,975,14,0.0141557128412538
192.03,2045,Mobile Home,28,23,5,0.178571428571429
192.03,2045,Multifamily,92,92,0,0
192.03,2045,Single Family - Detached,989,972,17,0.0171890798786653
192.03,2050,Mobile Home,28,23,5,0.178571428571429
192.03,2050,Multifamily,92,92,0,0
192.03,2050,Single Family - Detached,998,980,18,0.0180360721442886
192.05,2012,Mobile Home,568,461,107,0.188380281690141
192.05,2012,Multifamily,624,617,7,0.0112179487179487
192.05,2012,Single Family - Detached,955,948,7,0.00732984293193717
192.05,2020,Mobile Home,568,455,113,0.198943661971831
192.05,2020,Multifamily,624,617,7,0.0112179487179487
192.05,2020,Single Family - Detached,960,953,7,0.00729166666666667
192.05,2025,Mobile Home,568,455,113,0.198943661971831
192.05,2025,Multifamily,624,617,7,0.0112179487179487
192.05,2025,Single Family - Detached,962,956,6,0.00623700623700624
192.05,2030,Mobile Home,568,455,113,0.198943661971831
192.05,2030,Multifamily,624,616,8,0.0128205128205128
192.05,2030,Single Family - Detached,972,966,6,0.00617283950617284
192.05,2035,Mobile Home,568,455,113,0.198943661971831
192.05,2035,Multifamily,624,616,8,0.0128205128205128
192.05,2035,Single Family - Detached,973,967,6,0.00616649537512847
192.05,2040,Mobile Home,568,455,113,0.198943661971831
192.05,2040,Multifamily,624,610,14,0.0224358974358974
192.05,2040,Single Family - Detached,990,984,6,0.00606060606060606
192.05,2045,Mobile Home,568,455,113,0.198943661971831
192.05,2045,Multifamily,715,696,19,0.0265734265734266
192.05,2045,Single Family - Detached,1001,994,7,0.00699300699300699
192.05,2050,Mobile Home,568,449,119,0.209507042253521
192.05,2050,Multifamily,836,818,18,0.0215311004784689
192.05,2050,Single Family - Detached,1025,1018,7,0.00682926829268293
192.06,2012,Mobile Home,84,55,29,0.345238095238095
192.06,2012,Multifamily,467,459,8,0.0171306209850107
192.06,2012,Single Family - Detached,815,809,6,0.00736196319018405
192.06,2020,Mobile Home,0,0,0,
192.06,2020,Multifamily,467,460,7,0.0149892933618844
192.06,2020,Single Family - Detached,772,763,9,0.0116580310880829
192.06,2025,Mobile Home,0,0,0,
192.06,2025,Multifamily,853,831,22,0.0257913247362251
192.06,2025,Single Family - Detached,777,774,3,0.00386100386100386
192.06,2030,Mobile Home,0,0,0,
192.06,2030,Multifamily,853,827,26,0.0304806565064478
192.06,2030,Single Family - Detached,791,787,4,0.00505689001264223
192.06,2035,Mobile Home,0,0,0,
192.06,2035,Multifamily,948,921,27,0.0284810126582278
192.06,2035,Single Family - Detached,791,788,3,0.00379266750948167
192.06,2040,Mobile Home,0,0,0,
192.06,2040,Multifamily,1149,1095,54,0.0469973890339426
192.06,2040,Single Family - Detached,791,784,7,0.00884955752212389
192.06,2045,Mobile Home,0,0,0,
192.06,2045,Multifamily,1560,1480,80,0.0512820512820513
192.06,2045,Single Family - Detached,791,782,9,0.011378002528445
192.06,2050,Mobile Home,0,0,0,
192.06,2050,Multifamily,1560,1475,85,0.0544871794871795
192.06,2050,Single Family - Detached,791,781,10,0.0126422250316056
192.07,2012,Mobile Home,137,131,6,0.0437956204379562
192.07,2012,Multifamily,961,905,56,0.0582726326742976
192.07,2012,Single Family - Detached,1843,1790,53,0.0287574606619642
192.07,2020,Mobile Home,137,132,5,0.0364963503649635
192.07,2020,Multifamily,961,898,63,0.0655567117585848
192.07,2020,Single Family - Detached,1899,1823,76,0.0400210637177462
192.07,2025,Mobile Home,137,133,4,0.0291970802919708
192.07,2025,Multifamily,961,898,63,0.0655567117585848
192.07,2025,Single Family - Detached,2001,1925,76,0.0379810094952524
192.07,2030,Mobile Home,137,133,4,0.0291970802919708
192.07,2030,Multifamily,965,901,64,0.0663212435233161
192.07,2030,Single Family - Detached,2162,2081,81,0.0374653098982424
192.07,2035,Mobile Home,137,133,4,0.0291970802919708
192.07,2035,Multifamily,976,912,64,0.0655737704918033
192.07,2035,Single Family - Detached,2225,2150,75,0.0337078651685393
192.07,2040,Mobile Home,137,133,4,0.0291970802919708
192.07,2040,Multifamily,936,868,68,0.0726495726495727
192.07,2040,Single Family - Detached,2257,2173,84,0.0372175454142667
192.07,2045,Mobile Home,137,133,4,0.0291970802919708
192.07,2045,Multifamily,845,774,71,0.0840236686390533
192.07,2045,Single Family - Detached,2271,2179,92,0.0405107881990313
192.07,2050,Mobile Home,137,132,5,0.0364963503649635
192.07,2050,Multifamily,764,716,48,0.06282722513089
192.07,2050,Single Family - Detached,2271,2178,93,0.0409511228533686
192.08,2012,Mobile Home,0,0,0,
192.08,2012,Multifamily,0,0,0,
192.08,2012,Single Family - Detached,1115,1097,18,0.0161434977578475
192.08,2020,Mobile Home,0,0,0,
192.08,2020,Multifamily,0,0,0,
192.08,2020,Single Family - Detached,1190,1178,12,0.0100840336134454
192.08,2025,Mobile Home,0,0,0,
192.08,2025,Multifamily,0,0,0,
192.08,2025,Single Family - Detached,1237,1227,10,0.00808407437348424
192.08,2030,Mobile Home,0,0,0,
192.08,2030,Multifamily,0,0,0,
192.08,2030,Single Family - Detached,1317,1303,14,0.0106302201974184
192.08,2035,Mobile Home,0,0,0,
192.08,2035,Multifamily,0,0,0,
192.08,2035,Single Family - Detached,1377,1363,14,0.0101670297748729
192.08,2040,Mobile Home,0,0,0,
192.08,2040,Multifamily,0,0,0,
192.08,2040,Single Family - Detached,1395,1380,15,0.010752688172043
192.08,2045,Mobile Home,0,0,0,
192.08,2045,Multifamily,0,0,0,
192.08,2045,Single Family - Detached,1447,1428,19,0.0131306150656531
192.08,2050,Mobile Home,0,0,0,
192.08,2050,Multifamily,0,0,0,
192.08,2050,Single Family - Detached,1452,1432,20,0.0137741046831956
193.01,2012,Mobile Home,0,0,0,
193.01,2012,Multifamily,0,0,0,
193.01,2012,Single Family - Detached,2302,2245,57,0.024761077324066
193.01,2020,Mobile Home,0,0,0,
193.01,2020,Multifamily,0,0,0,
193.01,2020,Single Family - Detached,2328,2255,73,0.0313573883161512
193.01,2025,Mobile Home,0,0,0,
193.01,2025,Multifamily,0,0,0,
193.01,2025,Single Family - Detached,2328,2278,50,0.0214776632302405
193.01,2030,Mobile Home,0,0,0,
193.01,2030,Multifamily,0,0,0,
193.01,2030,Single Family - Detached,2335,2285,50,0.0214132762312634
193.01,2035,Mobile Home,0,0,0,
193.01,2035,Multifamily,0,0,0,
193.01,2035,Single Family - Detached,2350,2305,45,0.0191489361702128
193.01,2040,Mobile Home,0,0,0,
193.01,2040,Multifamily,0,0,0,
193.01,2040,Single Family - Detached,2384,2335,49,0.0205536912751678
193.01,2045,Mobile Home,0,0,0,
193.01,2045,Multifamily,0,0,0,
193.01,2045,Single Family - Detached,2389,2333,56,0.023440770196735
193.01,2050,Mobile Home,0,0,0,
193.01,2050,Multifamily,0,0,0,
193.01,2050,Single Family - Detached,2396,2340,56,0.0233722871452421
193.02,2012,Mobile Home,0,0,0,
193.02,2012,Multifamily,758,756,2,0.00263852242744063
193.02,2012,Single Family - Detached,2361,2255,106,0.0448962304108429
193.02,2020,Mobile Home,0,0,0,
193.02,2020,Multifamily,857,857,0,0
193.02,2020,Single Family - Detached,2367,2260,107,0.0452049007182087
193.02,2025,Mobile Home,0,0,0,
193.02,2025,Multifamily,858,858,0,0
193.02,2025,Single Family - Detached,2367,2275,92,0.0388677651035065
193.02,2030,Mobile Home,0,0,0,
193.02,2030,Multifamily,858,858,0,0
193.02,2030,Single Family - Detached,2367,2275,92,0.0388677651035065
193.02,2035,Mobile Home,0,0,0,
193.02,2035,Multifamily,858,858,0,0
193.02,2035,Single Family - Detached,2367,2279,88,0.0371778622729193
193.02,2040,Mobile Home,0,0,0,
193.02,2040,Multifamily,858,857,1,0.00116550116550117
193.02,2040,Single Family - Detached,2367,2275,92,0.0388677651035065
193.02,2045,Mobile Home,0,0,0,
193.02,2045,Multifamily,858,857,1,0.00116550116550117
193.02,2045,Single Family - Detached,2367,2265,102,0.0430925221799747
193.02,2050,Mobile Home,0,0,0,
193.02,2050,Multifamily,858,857,1,0.00116550116550117
193.02,2050,Single Family - Detached,2367,2264,103,0.0435149978876215
193.03,2012,Mobile Home,99,99,0,0
193.03,2012,Multifamily,332,302,30,0.0903614457831325
193.03,2012,Single Family - Detached,1880,1786,94,0.05
193.03,2020,Mobile Home,99,97,2,0.0202020202020202
193.03,2020,Multifamily,332,302,30,0.0903614457831325
193.03,2020,Single Family - Detached,2213,2107,106,0.0478987799367375
193.03,2025,Mobile Home,99,97,2,0.0202020202020202
193.03,2025,Multifamily,332,302,30,0.0903614457831325
193.03,2025,Single Family - Detached,2293,2204,89,0.0388137810728304
193.03,2030,Mobile Home,99,96,3,0.0303030303030303
193.03,2030,Multifamily,332,302,30,0.0903614457831325
193.03,2030,Single Family - Detached,2310,2221,89,0.0385281385281385
193.03,2035,Mobile Home,99,96,3,0.0303030303030303
193.03,2035,Multifamily,332,302,30,0.0903614457831325
193.03,2035,Single Family - Detached,2294,2211,83,0.0361813426329555
193.03,2040,Mobile Home,99,96,3,0.0303030303030303
193.03,2040,Multifamily,628,613,15,0.0238853503184713
193.03,2040,Single Family - Detached,2304,2219,85,0.0368923611111111
193.03,2045,Mobile Home,99,96,3,0.0303030303030303
193.03,2045,Multifamily,872,857,15,0.0172018348623853
193.03,2045,Single Family - Detached,2331,2243,88,0.0377520377520378
193.03,2050,Mobile Home,99,94,5,0.0505050505050505
193.03,2050,Multifamily,872,857,15,0.0172018348623853
193.03,2050,Single Family - Detached,2348,2261,87,0.0370528109028961
194.03,2012,Mobile Home,215,185,30,0.13953488372093
194.03,2012,Multifamily,2,0,2,1
194.03,2012,Single Family - Detached,1432,1384,48,0.0335195530726257
194.03,2020,Mobile Home,215,176,39,0.181395348837209
194.03,2020,Multifamily,2,1,1,0.5
194.03,2020,Single Family - Detached,1471,1417,54,0.0367097212780421
194.03,2025,Mobile Home,215,175,40,0.186046511627907
194.03,2025,Multifamily,140,135,5,0.0357142857142857
194.03,2025,Single Family - Detached,1471,1425,46,0.0312712440516655
194.03,2030,Mobile Home,215,172,43,0.2
194.03,2030,Multifamily,143,142,1,0.00699300699300699
194.03,2030,Single Family - Detached,1471,1424,47,0.0319510537049626
194.03,2035,Mobile Home,215,173,42,0.195348837209302
194.03,2035,Multifamily,181,180,1,0.00552486187845304
194.03,2035,Single Family - Detached,1471,1427,44,0.0299116247450714
194.03,2040,Mobile Home,215,175,40,0.186046511627907
194.03,2040,Multifamily,284,280,4,0.0140845070422535
194.03,2040,Single Family - Detached,1471,1424,47,0.0319510537049626
194.03,2045,Mobile Home,215,172,43,0.2
194.03,2045,Multifamily,366,360,6,0.0163934426229508
194.03,2045,Single Family - Detached,1471,1419,52,0.035350101971448
194.03,2050,Mobile Home,215,166,49,0.227906976744186
194.03,2050,Multifamily,366,360,6,0.0163934426229508
194.03,2050,Single Family - Detached,1471,1417,54,0.0367097212780421
194.04,2012,Mobile Home,0,0,0,
194.04,2012,Multifamily,100,84,16,0.16
194.04,2012,Single Family - Detached,734,723,11,0.0149863760217984
194.04,2020,Mobile Home,0,0,0,
194.04,2020,Multifamily,101,87,14,0.138613861386139
194.04,2020,Single Family - Detached,733,720,13,0.0177353342428377
194.04,2025,Mobile Home,0,0,0,
194.04,2025,Multifamily,381,369,12,0.031496062992126
194.04,2025,Single Family - Detached,735,725,10,0.0136054421768707
194.04,2030,Mobile Home,0,0,0,
194.04,2030,Multifamily,394,381,13,0.032994923857868
194.04,2030,Single Family - Detached,735,725,10,0.0136054421768707
194.04,2035,Mobile Home,0,0,0,
194.04,2035,Multifamily,479,465,14,0.0292275574112735
194.04,2035,Single Family - Detached,735,727,8,0.0108843537414966
194.04,2040,Mobile Home,0,0,0,
194.04,2040,Multifamily,480,457,23,0.0479166666666667
194.04,2040,Single Family - Detached,735,725,10,0.0136054421768707
194.04,2045,Mobile Home,0,0,0,
194.04,2045,Multifamily,613,580,33,0.0538336052202284
194.04,2045,Single Family - Detached,735,724,11,0.0149659863945578
194.04,2050,Mobile Home,0,0,0,
194.04,2050,Multifamily,613,575,38,0.0619902120717781
194.04,2050,Single Family - Detached,735,724,11,0.0149659863945578
194.05,2012,Mobile Home,0,0,0,
194.05,2012,Multifamily,762,691,71,0.0931758530183727
194.05,2012,Single Family - Detached,494,487,7,0.01417004048583
194.05,2020,Mobile Home,0,0,0,
194.05,2020,Multifamily,766,694,72,0.0939947780678851
194.05,2020,Single Family - Detached,490,483,7,0.0142857142857143
194.05,2025,Mobile Home,0,0,0,
194.05,2025,Multifamily,821,812,9,0.0109622411693057
194.05,2025,Single Family - Detached,490,485,5,0.0102040816326531
194.05,2030,Mobile Home,0,0,0,
194.05,2030,Multifamily,880,867,13,0.0147727272727273
194.05,2030,Single Family - Detached,490,484,6,0.0122448979591837
194.05,2035,Mobile Home,0,0,0,
194.05,2035,Multifamily,919,899,20,0.0217627856365615
194.05,2035,Single Family - Detached,529,525,4,0.00756143667296786
194.05,2040,Mobile Home,0,0,0,
194.05,2040,Multifamily,937,914,23,0.0245464247598719
194.05,2040,Single Family - Detached,574,567,7,0.0121951219512195
194.05,2045,Mobile Home,0,0,0,
194.05,2045,Multifamily,937,910,27,0.0288153681963714
194.05,2045,Single Family - Detached,574,566,8,0.0139372822299652
194.05,2050,Mobile Home,0,0,0,
194.05,2050,Multifamily,937,907,30,0.032017075773746
194.05,2050,Single Family - Detached,574,565,9,0.0156794425087108
194.06,2012,Mobile Home,76,73,3,0.0394736842105263
194.06,2012,Multifamily,530,505,25,0.0471698113207547
194.06,2012,Single Family - Detached,958,932,26,0.0271398747390397
194.06,2020,Mobile Home,76,74,2,0.0263157894736842
194.06,2020,Multifamily,530,505,25,0.0471698113207547
194.06,2020,Single Family - Detached,978,949,29,0.0296523517382413
194.06,2025,Mobile Home,76,74,2,0.0263157894736842
194.06,2025,Multifamily,530,504,26,0.0490566037735849
194.06,2025,Single Family - Detached,978,954,24,0.0245398773006135
194.06,2030,Mobile Home,76,74,2,0.0263157894736842
194.06,2030,Multifamily,544,534,10,0.0183823529411765
194.06,2030,Single Family - Detached,978,954,24,0.0245398773006135
194.06,2035,Mobile Home,76,74,2,0.0263157894736842
194.06,2035,Multifamily,544,531,13,0.0238970588235294
194.06,2035,Single Family - Detached,978,956,22,0.0224948875255624
194.06,2040,Mobile Home,76,74,2,0.0263157894736842
194.06,2040,Multifamily,544,530,14,0.0257352941176471
194.06,2040,Single Family - Detached,1000,990,10,0.01
194.06,2045,Mobile Home,76,74,2,0.0263157894736842
194.06,2045,Multifamily,549,533,16,0.029143897996357
194.06,2045,Single Family - Detached,1000,990,10,0.01
194.06,2050,Mobile Home,76,72,4,0.0526315789473684
194.06,2050,Multifamily,549,532,17,0.0309653916211293
194.06,2050,Single Family - Detached,1000,990,10,0.01
195.01,2012,Mobile Home,0,0,0,
195.01,2012,Multifamily,555,534,21,0.0378378378378378
195.01,2012,Single Family - Detached,325,315,10,0.0307692307692308
195.01,2020,Mobile Home,0,0,0,
195.01,2020,Multifamily,555,533,22,0.0396396396396396
195.01,2020,Single Family - Detached,325,315,10,0.0307692307692308
195.01,2025,Mobile Home,0,0,0,
195.01,2025,Multifamily,555,532,23,0.0414414414414414
195.01,2025,Single Family - Detached,325,317,8,0.0246153846153846
195.01,2030,Mobile Home,0,0,0,
195.01,2030,Multifamily,555,532,23,0.0414414414414414
195.01,2030,Single Family - Detached,325,317,8,0.0246153846153846
195.01,2035,Mobile Home,0,0,0,
195.01,2035,Multifamily,561,534,27,0.0481283422459893
195.01,2035,Single Family - Detached,322,315,7,0.0217391304347826
195.01,2040,Mobile Home,0,0,0,
195.01,2040,Multifamily,749,711,38,0.0507343124165554
195.01,2040,Single Family - Detached,322,314,8,0.0248447204968944
195.01,2045,Mobile Home,0,0,0,
195.01,2045,Multifamily,757,716,41,0.0541611624834875
195.01,2045,Single Family - Detached,322,314,8,0.0248447204968944
195.01,2050,Mobile Home,0,0,0,
195.01,2050,Multifamily,819,775,44,0.0537240537240537
195.01,2050,Single Family - Detached,322,314,8,0.0248447204968944
195.02,2012,Mobile Home,0,0,0,
195.02,2012,Multifamily,621,598,23,0.037037037037037
195.02,2012,Single Family - Detached,736,717,19,0.0258152173913043
195.02,2020,Mobile Home,0,0,0,
195.02,2020,Multifamily,621,591,30,0.0483091787439614
195.02,2020,Single Family - Detached,736,715,21,0.0285326086956522
195.02,2025,Mobile Home,0,0,0,
195.02,2025,Multifamily,621,576,45,0.072463768115942
195.02,2025,Single Family - Detached,736,720,16,0.0217391304347826
195.02,2030,Mobile Home,0,0,0,
195.02,2030,Multifamily,621,559,62,0.0998389694041868
195.02,2030,Single Family - Detached,736,720,16,0.0217391304347826
195.02,2035,Mobile Home,0,0,0,
195.02,2035,Multifamily,577,507,70,0.121317157712305
195.02,2035,Single Family - Detached,687,671,16,0.0232896652110626
195.02,2040,Mobile Home,0,0,0,
195.02,2040,Multifamily,1058,947,111,0.104914933837429
195.02,2040,Single Family - Detached,684,665,19,0.0277777777777778
195.02,2045,Mobile Home,0,0,0,
195.02,2045,Multifamily,1326,1197,129,0.0972850678733032
195.02,2045,Single Family - Detached,682,662,20,0.0293255131964809
195.02,2050,Mobile Home,0,0,0,
195.02,2050,Multifamily,1446,1314,132,0.0912863070539419
195.02,2050,Single Family - Detached,673,653,20,0.0297176820208024
195.03,2012,Mobile Home,225,225,0,0
195.03,2012,Multifamily,550,525,25,0.0454545454545455
195.03,2012,Single Family - Detached,721,713,8,0.0110957004160888
195.03,2020,Mobile Home,197,197,0,0
195.03,2020,Multifamily,509,484,25,0.0491159135559921
195.03,2020,Single Family - Detached,666,655,11,0.0165165165165165
195.03,2025,Mobile Home,197,197,0,0
195.03,2025,Multifamily,964,906,58,0.0601659751037344
195.03,2025,Single Family - Detached,592,583,9,0.0152027027027027
195.03,2030,Mobile Home,197,196,1,0.0050761421319797
195.03,2030,Multifamily,1753,1649,104,0.0593268682258985
195.03,2030,Single Family - Detached,536,527,9,0.0167910447761194
195.03,2035,Mobile Home,197,195,2,0.0101522842639594
195.03,2035,Multifamily,2643,2482,161,0.0609156261823685
195.03,2035,Single Family - Detached,536,528,8,0.0149253731343284
195.03,2040,Mobile Home,197,196,1,0.0050761421319797
195.03,2040,Multifamily,2754,2574,180,0.065359477124183
195.03,2040,Single Family - Detached,536,526,10,0.0186567164179104
195.03,2045,Mobile Home,197,195,2,0.0101522842639594
195.03,2045,Multifamily,2757,2563,194,0.0703663402248821
195.03,2045,Single Family - Detached,536,525,11,0.0205223880597015
195.03,2050,Mobile Home,197,192,5,0.0253807106598985
195.03,2050,Multifamily,2757,2551,206,0.0747188973521944
195.03,2050,Single Family - Detached,536,525,11,0.0205223880597015
196.01,2012,Mobile Home,28,28,0,0
196.01,2012,Multifamily,621,616,5,0.00805152979066022
196.01,2012,Single Family - Detached,1542,1467,75,0.0486381322957198
196.01,2020,Mobile Home,28,28,0,0
196.01,2020,Multifamily,621,602,19,0.0305958132045089
196.01,2020,Single Family - Detached,1542,1467,75,0.0486381322957198
196.01,2025,Mobile Home,28,28,0,0
196.01,2025,Multifamily,625,609,16,0.0256
196.01,2025,Single Family - Detached,1577,1524,53,0.0336081166772353
196.01,2030,Mobile Home,28,27,1,0.0357142857142857
196.01,2030,Multifamily,628,607,21,0.0334394904458599
196.01,2030,Single Family - Detached,1625,1572,53,0.0326153846153846
196.01,2035,Mobile Home,28,27,1,0.0357142857142857
196.01,2035,Multifamily,630,610,20,0.0317460317460317
196.01,2035,Single Family - Detached,1629,1577,52,0.0319214241866176
196.01,2040,Mobile Home,28,27,1,0.0357142857142857
196.01,2040,Multifamily,637,607,30,0.0470957613814757
196.01,2040,Single Family - Detached,1640,1587,53,0.0323170731707317
196.01,2045,Mobile Home,28,26,2,0.0714285714285714
196.01,2045,Multifamily,650,615,35,0.0538461538461538
196.01,2045,Single Family - Detached,1644,1588,56,0.0340632603406326
196.01,2050,Mobile Home,28,24,4,0.142857142857143
196.01,2050,Multifamily,670,628,42,0.0626865671641791
196.01,2050,Single Family - Detached,1647,1590,57,0.034608378870674
196.02,2012,Mobile Home,31,31,0,0
196.02,2012,Multifamily,449,412,37,0.0824053452115813
196.02,2012,Single Family - Detached,1253,1226,27,0.0215482841181165
196.02,2020,Mobile Home,31,31,0,0
196.02,2020,Multifamily,424,413,11,0.0259433962264151
196.02,2020,Single Family - Detached,1254,1225,29,0.0231259968102073
196.02,2025,Mobile Home,0,0,0,
196.02,2025,Multifamily,674,660,14,0.0207715133531157
196.02,2025,Single Family - Detached,1353,1323,30,0.0221729490022173
196.02,2030,Mobile Home,0,0,0,
196.02,2030,Multifamily,806,792,14,0.0173697270471464
196.02,2030,Single Family - Detached,1444,1423,21,0.0145429362880886
196.02,2035,Mobile Home,0,0,0,
196.02,2035,Multifamily,921,906,15,0.0162866449511401
196.02,2035,Single Family - Detached,1476,1455,21,0.0142276422764228
196.02,2040,Mobile Home,0,0,0,
196.02,2040,Multifamily,1263,1243,20,0.0158353127474268
196.02,2040,Single Family - Detached,1495,1465,30,0.020066889632107
196.02,2045,Mobile Home,0,0,0,
196.02,2045,Multifamily,1966,1916,50,0.0254323499491353
196.02,2045,Single Family - Detached,1495,1456,39,0.0260869565217391
196.02,2050,Mobile Home,0,0,0,
196.02,2050,Multifamily,2674,2574,100,0.037397157816006
196.02,2050,Single Family - Detached,1506,1466,40,0.0265604249667995
197.01,2012,Mobile Home,375,349,26,0.0693333333333333
197.01,2012,Multifamily,1259,1119,140,0.11119936457506
197.01,2012,Single Family - Detached,735,721,14,0.019047619047619
197.01,2020,Mobile Home,375,351,24,0.064
197.01,2020,Multifamily,1259,1119,140,0.11119936457506
197.01,2020,Single Family - Detached,789,770,19,0.0240811153358682
197.01,2025,Mobile Home,375,351,24,0.064
197.01,2025,Multifamily,1259,1119,140,0.11119936457506
197.01,2025,Single Family - Detached,852,838,14,0.0164319248826291
197.01,2030,Mobile Home,375,347,28,0.0746666666666667
197.01,2030,Multifamily,1261,1121,140,0.111022997620936
197.01,2030,Single Family - Detached,980,962,18,0.0183673469387755
197.01,2035,Mobile Home,375,348,27,0.072
197.01,2035,Multifamily,1283,1198,85,0.0662509742790335
197.01,2035,Single Family - Detached,1069,1052,17,0.0159027128157156
197.01,2040,Mobile Home,375,349,26,0.0693333333333333
197.01,2040,Multifamily,1315,1230,85,0.064638783269962
197.01,2040,Single Family - Detached,1072,1045,27,0.0251865671641791
197.01,2045,Mobile Home,375,347,28,0.0746666666666667
197.01,2045,Multifamily,1315,1229,86,0.0653992395437262
197.01,2045,Single Family - Detached,1072,1037,35,0.0326492537313433
197.01,2050,Mobile Home,375,337,38,0.101333333333333
197.01,2050,Multifamily,1315,1229,86,0.0653992395437262
197.01,2050,Single Family - Detached,1072,1035,37,0.0345149253731343
197.02,2012,Mobile Home,0,0,0,
197.02,2012,Multifamily,84,82,2,0.0238095238095238
197.02,2012,Single Family - Detached,1641,1576,65,0.0396099939061548
197.02,2020,Mobile Home,0,0,0,
197.02,2020,Multifamily,95,90,5,0.0526315789473684
197.02,2020,Single Family - Detached,1637,1571,66,0.0403176542455712
197.02,2025,Mobile Home,0,0,0,
197.02,2025,Multifamily,242,229,13,0.0537190082644628
197.02,2025,Single Family - Detached,1637,1576,61,0.0372632864996946
197.02,2030,Mobile Home,0,0,0,
197.02,2030,Multifamily,244,228,16,0.0655737704918033
197.02,2030,Single Family - Detached,1637,1576,61,0.0372632864996946
197.02,2035,Mobile Home,0,0,0,
197.02,2035,Multifamily,250,234,16,0.064
197.02,2035,Single Family - Detached,1638,1580,58,0.0354090354090354
197.02,2040,Mobile Home,0,0,0,
197.02,2040,Multifamily,255,237,18,0.0705882352941176
197.02,2040,Single Family - Detached,1705,1643,62,0.0363636363636364
197.02,2045,Mobile Home,0,0,0,
197.02,2045,Multifamily,264,245,19,0.071969696969697
197.02,2045,Single Family - Detached,1705,1641,64,0.0375366568914956
197.02,2050,Mobile Home,0,0,0,
197.02,2050,Multifamily,265,244,21,0.0792452830188679
197.02,2050,Single Family - Detached,1711,1646,65,0.037989479836353
198.03,2012,Mobile Home,0,0,0,
198.03,2012,Multifamily,224,210,14,0.0625
198.03,2012,Single Family - Detached,1613,1508,105,0.0650960942343459
198.03,2020,Mobile Home,0,0,0,
198.03,2020,Multifamily,514,494,20,0.0389105058365759
198.03,2020,Single Family - Detached,1979,1849,130,0.0656897422940879
198.03,2025,Mobile Home,0,0,0,
198.03,2025,Multifamily,514,494,20,0.0389105058365759
198.03,2025,Single Family - Detached,1979,1862,117,0.0591207680646791
198.03,2030,Mobile Home,0,0,0,
198.03,2030,Multifamily,514,494,20,0.0389105058365759
198.03,2030,Single Family - Detached,1979,1860,119,0.0601313794845882
198.03,2035,Mobile Home,0,0,0,
198.03,2035,Multifamily,514,494,20,0.0389105058365759
198.03,2035,Single Family - Detached,2000,1886,114,0.057
198.03,2040,Mobile Home,0,0,0,
198.03,2040,Multifamily,514,492,22,0.0428015564202335
198.03,2040,Single Family - Detached,2000,1889,111,0.0555
198.03,2045,Mobile Home,0,0,0,
198.03,2045,Multifamily,514,492,22,0.0428015564202335
198.03,2045,Single Family - Detached,2000,1887,113,0.0565
198.03,2050,Mobile Home,0,0,0,
198.03,2050,Multifamily,514,492,22,0.0428015564202335
198.03,2050,Single Family - Detached,2001,1887,114,0.0569715142428786
198.04,2012,Mobile Home,0,0,0,
198.04,2012,Multifamily,0,0,0,
198.04,2012,Single Family - Detached,1719,1672,47,0.0273414776032577
198.04,2020,Mobile Home,0,0,0,
198.04,2020,Multifamily,0,0,0,
198.04,2020,Single Family - Detached,1719,1665,54,0.031413612565445
198.04,2025,Mobile Home,0,0,0,
198.04,2025,Multifamily,0,0,0,
198.04,2025,Single Family - Detached,1719,1675,44,0.0255962769051774
198.04,2030,Mobile Home,0,0,0,
198.04,2030,Multifamily,0,0,0,
198.04,2030,Single Family - Detached,1719,1675,44,0.0255962769051774
198.04,2035,Mobile Home,0,0,0,
198.04,2035,Multifamily,0,0,0,
198.04,2035,Single Family - Detached,1724,1681,43,0.0249419953596288
198.04,2040,Mobile Home,0,0,0,
198.04,2040,Multifamily,0,0,0,
198.04,2040,Single Family - Detached,1724,1681,43,0.0249419953596288
198.04,2045,Mobile Home,0,0,0,
198.04,2045,Multifamily,0,0,0,
198.04,2045,Single Family - Detached,1724,1681,43,0.0249419953596288
198.04,2050,Mobile Home,0,0,0,
198.04,2050,Multifamily,0,0,0,
198.04,2050,Single Family - Detached,1724,1680,44,0.0255220417633411
198.05,2012,Mobile Home,160,160,0,0
198.05,2012,Multifamily,717,670,47,0.0655509065550907
198.05,2012,Single Family - Detached,840,805,35,0.0416666666666667
198.05,2020,Mobile Home,160,160,0,0
198.05,2020,Multifamily,718,674,44,0.0612813370473538
198.05,2020,Single Family - Detached,857,816,41,0.0478413068844807
198.05,2025,Mobile Home,160,160,0,0
198.05,2025,Multifamily,794,754,40,0.0503778337531486
198.05,2025,Single Family - Detached,857,829,28,0.0326721120186698
198.05,2030,Mobile Home,160,160,0,0
198.05,2030,Multifamily,842,801,41,0.0486935866983373
198.05,2030,Single Family - Detached,857,828,29,0.0338389731621937
198.05,2035,Mobile Home,160,160,0,0
198.05,2035,Multifamily,888,847,41,0.0461711711711712
198.05,2035,Single Family - Detached,857,833,24,0.0280046674445741
198.05,2040,Mobile Home,160,160,0,0
198.05,2040,Multifamily,912,868,44,0.0482456140350877
198.05,2040,Single Family - Detached,857,830,27,0.0315052508751459
198.05,2045,Mobile Home,160,160,0,0
198.05,2045,Multifamily,907,860,47,0.051819184123484
198.05,2045,Single Family - Detached,857,824,33,0.0385064177362894
198.05,2050,Mobile Home,160,159,1,0.00625
198.05,2050,Multifamily,905,856,49,0.0541436464088398
198.05,2050,Single Family - Detached,857,822,35,0.0408401400233372
198.06,2012,Mobile Home,501,441,60,0.119760479041916
198.06,2012,Multifamily,739,728,11,0.0148849797023004
198.06,2012,Single Family - Detached,2941,2825,116,0.0394423665419925
198.06,2020,Mobile Home,501,443,58,0.115768463073852
198.06,2020,Multifamily,1172,1149,23,0.0196245733788396
198.06,2020,Single Family - Detached,3535,3391,144,0.0407355021216407
198.06,2025,Mobile Home,501,442,59,0.117764471057884
198.06,2025,Multifamily,1177,1150,27,0.0229396771452846
198.06,2025,Single Family - Detached,3572,3468,104,0.0291153415453527
198.06,2030,Mobile Home,501,439,62,0.12375249500998
198.06,2030,Multifamily,1177,1150,27,0.0229396771452846
198.06,2030,Single Family - Detached,3584,3477,107,0.0298549107142857
198.06,2035,Mobile Home,501,439,62,0.12375249500998
198.06,2035,Multifamily,1177,1151,26,0.022090059473237
198.06,2035,Single Family - Detached,3661,3566,95,0.0259491942092324
198.06,2040,Mobile Home,501,440,61,0.121756487025948
198.06,2040,Multifamily,1177,1150,27,0.0229396771452846
198.06,2040,Single Family - Detached,3662,3568,94,0.0256690333151283
198.06,2045,Mobile Home,501,438,63,0.125748502994012
198.06,2045,Multifamily,1177,1149,28,0.0237892948173322
198.06,2045,Single Family - Detached,3662,3565,97,0.0264882577826324
198.06,2050,Mobile Home,501,429,72,0.143712574850299
198.06,2050,Multifamily,1177,1148,29,0.0246389124893798
198.06,2050,Single Family - Detached,3663,3562,101,0.0275730275730276
198.08,2012,Mobile Home,0,0,0,
198.08,2012,Multifamily,294,294,0,0
198.08,2012,Single Family - Detached,2156,2015,141,0.0653988868274583
198.08,2020,Mobile Home,0,0,0,
198.08,2020,Multifamily,294,294,0,0
198.08,2020,Single Family - Detached,2156,2009,147,0.0681818181818182
198.08,2025,Mobile Home,0,0,0,
198.08,2025,Multifamily,294,294,0,0
198.08,2025,Single Family - Detached,2156,2031,125,0.0579777365491651
198.08,2030,Mobile Home,0,0,0,
198.08,2030,Multifamily,294,294,0,0
198.08,2030,Single Family - Detached,2156,2031,125,0.0579777365491651
198.08,2035,Mobile Home,0,0,0,
198.08,2035,Multifamily,294,294,0,0
198.08,2035,Single Family - Detached,2156,2036,120,0.0556586270871985
198.08,2040,Mobile Home,0,0,0,
198.08,2040,Multifamily,294,293,1,0.00340136054421769
198.08,2040,Single Family - Detached,2156,2031,125,0.0579777365491651
198.08,2045,Mobile Home,0,0,0,
198.08,2045,Multifamily,294,293,1,0.00340136054421769
198.08,2045,Single Family - Detached,2156,2022,134,0.062152133580705
198.08,2050,Mobile Home,0,0,0,
198.08,2050,Multifamily,294,293,1,0.00340136054421769
198.08,2050,Single Family - Detached,2156,2019,137,0.063543599257885
198.09,2012,Mobile Home,325,319,6,0.0184615384615385
198.09,2012,Multifamily,1,0,1,1
198.09,2012,Single Family - Detached,1396,1309,87,0.0623209169054441
198.09,2020,Mobile Home,325,320,5,0.0153846153846154
198.09,2020,Multifamily,1,1,0,0
198.09,2020,Single Family - Detached,1397,1297,100,0.0715819613457409
198.09,2025,Mobile Home,325,320,5,0.0153846153846154
198.09,2025,Multifamily,1,1,0,0
198.09,2025,Single Family - Detached,1544,1464,80,0.0518134715025907
198.09,2030,Mobile Home,325,318,7,0.0215384615384615
198.09,2030,Multifamily,1,0,1,1
198.09,2030,Single Family - Detached,1547,1463,84,0.0542986425339367
198.09,2035,Mobile Home,325,318,7,0.0215384615384615
198.09,2035,Multifamily,1,1,0,0
198.09,2035,Single Family - Detached,1548,1472,76,0.0490956072351421
198.09,2040,Mobile Home,325,319,6,0.0184615384615385
198.09,2040,Multifamily,1,0,1,1
198.09,2040,Single Family - Detached,1558,1472,86,0.055198973042362
198.09,2045,Mobile Home,325,317,8,0.0246153846153846
198.09,2045,Multifamily,1,0,1,1
198.09,2045,Single Family - Detached,1564,1469,95,0.0607416879795396
198.09,2050,Mobile Home,325,311,14,0.0430769230769231
198.09,2050,Multifamily,1,0,1,1
198.09,2050,Single Family - Detached,1565,1467,98,0.0626198083067093
199.02,2012,Mobile Home,0,0,0,
199.02,2012,Multifamily,420,400,20,0.0476190476190476
199.02,2012,Single Family - Detached,876,845,31,0.0353881278538813
199.02,2020,Mobile Home,0,0,0,
199.02,2020,Multifamily,422,405,17,0.0402843601895735
199.02,2020,Single Family - Detached,904,864,40,0.0442477876106195
199.02,2025,Mobile Home,0,0,0,
199.02,2025,Multifamily,423,414,9,0.0212765957446809
199.02,2025,Single Family - Detached,1071,1042,29,0.027077497665733
199.02,2030,Mobile Home,0,0,0,
199.02,2030,Multifamily,423,414,9,0.0212765957446809
199.02,2030,Single Family - Detached,1071,1028,43,0.0401493930905696
199.02,2035,Mobile Home,0,0,0,
199.02,2035,Multifamily,423,415,8,0.0189125295508274
199.02,2035,Single Family - Detached,1071,1021,50,0.0466853408029879
199.02,2040,Mobile Home,0,0,0,
199.02,2040,Multifamily,431,419,12,0.0278422273781903
199.02,2040,Single Family - Detached,1087,1027,60,0.0551977920883165
199.02,2045,Mobile Home,0,0,0,
199.02,2045,Multifamily,760,731,29,0.0381578947368421
199.02,2045,Single Family - Detached,1086,1021,65,0.0598526703499079
199.02,2050,Mobile Home,0,0,0,
199.02,2050,Multifamily,760,731,29,0.0381578947368421
199.02,2050,Single Family - Detached,1086,1017,69,0.0635359116022099
199.03,2012,Mobile Home,41,41,0,0
199.03,2012,Multifamily,282,276,6,0.0212765957446809
199.03,2012,Single Family - Detached,1197,1168,29,0.0242272347535505
199.03,2020,Mobile Home,41,41,0,0
199.03,2020,Multifamily,279,272,7,0.025089605734767
199.03,2020,Single Family - Detached,1255,1224,31,0.0247011952191235
199.03,2025,Mobile Home,41,41,0,0
199.03,2025,Multifamily,258,254,4,0.0155038759689922
199.03,2025,Single Family - Detached,1358,1327,31,0.0228276877761414
199.03,2030,Mobile Home,41,40,1,0.024390243902439
199.03,2030,Multifamily,243,239,4,0.0164609053497942
199.03,2030,Single Family - Detached,1529,1498,31,0.0202746893394375
199.03,2035,Mobile Home,41,40,1,0.024390243902439
199.03,2035,Multifamily,243,239,4,0.0164609053497942
199.03,2035,Single Family - Detached,1639,1624,15,0.00915192190359976
199.03,2040,Mobile Home,41,40,1,0.024390243902439
199.03,2040,Multifamily,243,237,6,0.0246913580246914
199.03,2040,Single Family - Detached,1718,1703,15,0.00873108265424913
199.03,2045,Mobile Home,41,39,2,0.0487804878048781
199.03,2045,Multifamily,366,343,23,0.0628415300546448
199.03,2045,Single Family - Detached,1725,1708,17,0.00985507246376812
199.03,2050,Mobile Home,41,37,4,0.0975609756097561
199.03,2050,Multifamily,366,342,24,0.0655737704918033
199.03,2050,Single Family - Detached,1735,1717,18,0.0103746397694524
199.04,2012,Mobile Home,1,1,0,0
199.04,2012,Multifamily,1478,1400,78,0.0527740189445196
199.04,2012,Single Family - Detached,1420,1332,88,0.0619718309859155
199.04,2020,Mobile Home,1,1,0,0
199.04,2020,Multifamily,1478,1400,78,0.0527740189445196
199.04,2020,Single Family - Detached,1422,1330,92,0.0646976090014065
199.04,2025,Mobile Home,1,0,1,1
199.04,2025,Multifamily,1500,1453,47,0.0313333333333333
199.04,2025,Single Family - Detached,1427,1357,70,0.0490539593552908
199.04,2030,Mobile Home,1,0,1,1
199.04,2030,Multifamily,1500,1453,47,0.0313333333333333
199.04,2030,Single Family - Detached,1428,1357,71,0.0497198879551821
199.04,2035,Mobile Home,1,1,0,0
199.04,2035,Multifamily,1500,1453,47,0.0313333333333333
199.04,2035,Single Family - Detached,1415,1353,62,0.0438162544169611
199.04,2040,Mobile Home,1,1,0,0
199.04,2040,Multifamily,1500,1453,47,0.0313333333333333
199.04,2040,Single Family - Detached,1425,1355,70,0.0491228070175439
199.04,2045,Mobile Home,1,0,1,1
199.04,2045,Multifamily,1500,1453,47,0.0313333333333333
199.04,2045,Single Family - Detached,1425,1351,74,0.0519298245614035
199.04,2050,Mobile Home,1,0,1,1
199.04,2050,Multifamily,1500,1453,47,0.0313333333333333
199.04,2050,Single Family - Detached,1436,1361,75,0.0522284122562674
199.05,2012,Mobile Home,0,0,0,
199.05,2012,Multifamily,683,636,47,0.068814055636896
199.05,2012,Single Family - Detached,1212,1144,68,0.0561056105610561
199.05,2020,Mobile Home,0,0,0,
199.05,2020,Multifamily,683,641,42,0.061493411420205
199.05,2020,Single Family - Detached,1211,1143,68,0.0561519405450041
199.05,2025,Mobile Home,0,0,0,
199.05,2025,Multifamily,691,642,49,0.0709117221418234
199.05,2025,Single Family - Detached,1202,1145,57,0.0474209650582363
199.05,2030,Mobile Home,0,0,0,
199.05,2030,Multifamily,691,642,49,0.0709117221418234
199.05,2030,Single Family - Detached,1202,1142,60,0.0499168053244592
199.05,2035,Mobile Home,0,0,0,
199.05,2035,Multifamily,691,645,46,0.0665701881331404
199.05,2035,Single Family - Detached,1214,1155,59,0.0485996705107084
199.05,2040,Mobile Home,0,0,0,
199.05,2040,Multifamily,691,642,49,0.0709117221418234
199.05,2040,Single Family - Detached,1215,1151,64,0.0526748971193416
199.05,2045,Mobile Home,0,0,0,
199.05,2045,Multifamily,691,642,49,0.0709117221418234
199.05,2045,Single Family - Detached,1215,1151,64,0.0526748971193416
199.05,2050,Mobile Home,0,0,0,
199.05,2050,Multifamily,691,641,50,0.0723589001447178
199.05,2050,Single Family - Detached,1215,1147,68,0.0559670781893004
20.01,2012,Mobile Home,0,0,0,
20.01,2012,Multifamily,46,46,0,0
20.01,2012,Single Family - Detached,1560,1554,6,0.00384615384615385
20.01,2020,Mobile Home,0,0,0,
20.01,2020,Multifamily,46,43,3,0.0652173913043478
20.01,2020,Single Family - Detached,1577,1567,10,0.00634115409004439
20.01,2025,Mobile Home,0,0,0,
20.01,2025,Multifamily,46,43,3,0.0652173913043478
20.01,2025,Single Family - Detached,1577,1571,6,0.00380469245402663
20.01,2030,Mobile Home,0,0,0,
20.01,2030,Multifamily,109,101,8,0.073394495412844
20.01,2030,Single Family - Detached,1576,1568,8,0.0050761421319797
20.01,2035,Mobile Home,0,0,0,
20.01,2035,Multifamily,109,97,12,0.110091743119266
20.01,2035,Single Family - Detached,1576,1568,8,0.0050761421319797
20.01,2040,Mobile Home,0,0,0,
20.01,2040,Multifamily,109,94,15,0.137614678899083
20.01,2040,Single Family - Detached,1577,1570,7,0.00443880786303107
20.01,2045,Mobile Home,0,0,0,
20.01,2045,Multifamily,109,93,16,0.146788990825688
20.01,2045,Single Family - Detached,1580,1569,11,0.0069620253164557
20.01,2050,Mobile Home,0,0,0,
20.01,2050,Multifamily,109,92,17,0.155963302752294
20.01,2050,Single Family - Detached,1580,1567,13,0.00822784810126582
200.13,2012,Mobile Home,0,0,0,
200.13,2012,Multifamily,1131,994,137,0.121131741821397
200.13,2012,Single Family - Detached,3790,3660,130,0.0343007915567282
200.13,2020,Mobile Home,0,0,0,
200.13,2020,Multifamily,1131,994,137,0.121131741821397
200.13,2020,Single Family - Detached,3853,3706,147,0.0381520892810797
200.13,2025,Mobile Home,0,0,0,
200.13,2025,Multifamily,1131,1002,129,0.114058355437666
200.13,2025,Single Family - Detached,3879,3762,117,0.0301624129930394
200.13,2030,Mobile Home,0,0,0,
200.13,2030,Multifamily,1131,1002,129,0.114058355437666
200.13,2030,Single Family - Detached,3889,3769,120,0.0308562612496786
200.13,2035,Mobile Home,0,0,0,
200.13,2035,Multifamily,1131,1002,129,0.114058355437666
200.13,2035,Single Family - Detached,3914,3815,99,0.0252938170669392
200.13,2040,Mobile Home,0,0,0,
200.13,2040,Multifamily,1131,999,132,0.116710875331565
200.13,2040,Single Family - Detached,3914,3810,104,0.0265712825753705
200.13,2045,Mobile Home,0,0,0,
200.13,2045,Multifamily,1131,999,132,0.116710875331565
200.13,2045,Single Family - Detached,3914,3803,111,0.0283597342871742
200.13,2050,Mobile Home,0,0,0,
200.13,2050,Multifamily,1131,999,132,0.116710875331565
200.13,2050,Single Family - Detached,3914,3800,114,0.029126213592233
200.14,2012,Mobile Home,0,0,0,
200.14,2012,Multifamily,1293,1266,27,0.0208816705336427
200.14,2012,Single Family - Detached,2041,1832,209,0.102400783929446
200.14,2020,Mobile Home,0,0,0,
200.14,2020,Multifamily,1294,1265,29,0.0224111282843895
200.14,2020,Single Family - Detached,2048,1817,231,0.11279296875
200.14,2025,Mobile Home,0,0,0,
200.14,2025,Multifamily,1333,1315,18,0.013503375843961
200.14,2025,Single Family - Detached,2049,1865,184,0.0897999023914104
200.14,2030,Mobile Home,0,0,0,
200.14,2030,Multifamily,1333,1315,18,0.013503375843961
200.14,2030,Single Family - Detached,2055,1866,189,0.091970802919708
200.14,2035,Mobile Home,0,0,0,
200.14,2035,Multifamily,1333,1317,16,0.0120030007501875
200.14,2035,Single Family - Detached,2080,1891,189,0.0908653846153846
200.14,2040,Mobile Home,0,0,0,
200.14,2040,Multifamily,1333,1315,18,0.013503375843961
200.14,2040,Single Family - Detached,2080,1885,195,0.09375
200.14,2045,Mobile Home,0,0,0,
200.14,2045,Multifamily,1333,1314,19,0.0142535633908477
200.14,2045,Single Family - Detached,2080,1881,199,0.0956730769230769
200.14,2050,Mobile Home,0,0,0,
200.14,2050,Multifamily,1333,1313,20,0.0150037509377344
200.14,2050,Single Family - Detached,2080,1881,199,0.0956730769230769
200.15,2012,Mobile Home,0,0,0,
200.15,2012,Multifamily,1150,1116,34,0.0295652173913043
200.15,2012,Single Family - Detached,856,769,87,0.101635514018692
200.15,2020,Mobile Home,0,0,0,
200.15,2020,Multifamily,1211,1187,24,0.0198183319570603
200.15,2020,Single Family - Detached,1025,934,91,0.088780487804878
200.15,2025,Mobile Home,0,0,0,
200.15,2025,Multifamily,1215,1197,18,0.0148148148148148
200.15,2025,Single Family - Detached,1025,945,80,0.0780487804878049
200.15,2030,Mobile Home,0,0,0,
200.15,2030,Multifamily,1245,1227,18,0.0144578313253012
200.15,2030,Single Family - Detached,1025,945,80,0.0780487804878049
200.15,2035,Mobile Home,0,0,0,
200.15,2035,Multifamily,1264,1247,17,0.0134493670886076
200.15,2035,Single Family - Detached,1025,949,76,0.0741463414634146
200.15,2040,Mobile Home,0,0,0,
200.15,2040,Multifamily,1264,1246,18,0.0142405063291139
200.15,2040,Single Family - Detached,1025,951,74,0.0721951219512195
200.15,2045,Mobile Home,0,0,0,
200.15,2045,Multifamily,1264,1246,18,0.0142405063291139
200.15,2045,Single Family - Detached,1025,951,74,0.0721951219512195
200.15,2050,Mobile Home,0,0,0,
200.15,2050,Multifamily,1264,1246,18,0.0142405063291139
200.15,2050,Single Family - Detached,1025,951,74,0.0721951219512195
200.16,2012,Mobile Home,0,0,0,
200.16,2012,Multifamily,142,108,34,0.23943661971831
200.16,2012,Single Family - Detached,3124,3029,95,0.0304097311139565
200.16,2020,Mobile Home,0,0,0,
200.16,2020,Multifamily,184,140,44,0.239130434782609
200.16,2020,Single Family - Detached,3208,3084,124,0.0386533665835411
200.16,2025,Mobile Home,0,0,0,
200.16,2025,Multifamily,184,145,39,0.21195652173913
200.16,2025,Single Family - Detached,3208,3119,89,0.0277431421446384
200.16,2030,Mobile Home,0,0,0,
200.16,2030,Multifamily,184,142,42,0.228260869565217
200.16,2030,Single Family - Detached,3208,3114,94,0.0293017456359102
200.16,2035,Mobile Home,0,0,0,
200.16,2035,Multifamily,194,155,39,0.201030927835052
200.16,2035,Single Family - Detached,3208,3125,83,0.0258728179551122
200.16,2040,Mobile Home,0,0,0,
200.16,2040,Multifamily,194,152,42,0.216494845360825
200.16,2040,Single Family - Detached,3208,3125,83,0.0258728179551122
200.16,2045,Mobile Home,0,0,0,
200.16,2045,Multifamily,194,151,43,0.221649484536082
200.16,2045,Single Family - Detached,3208,3121,87,0.0271197007481297
200.16,2050,Mobile Home,0,0,0,
200.16,2050,Multifamily,194,150,44,0.22680412371134
200.16,2050,Single Family - Detached,3208,3115,93,0.0289900249376559
200.17,2012,Mobile Home,186,179,7,0.0376344086021505
200.17,2012,Multifamily,710,627,83,0.116901408450704
200.17,2012,Single Family - Detached,328,315,13,0.0396341463414634
200.17,2020,Mobile Home,186,180,6,0.032258064516129
200.17,2020,Multifamily,710,627,83,0.116901408450704
200.17,2020,Single Family - Detached,471,453,18,0.0382165605095541
200.17,2025,Mobile Home,186,180,6,0.032258064516129
200.17,2025,Multifamily,710,624,86,0.12112676056338
200.17,2025,Single Family - Detached,604,589,15,0.0248344370860927
200.17,2030,Mobile Home,186,180,6,0.032258064516129
200.17,2030,Multifamily,710,624,86,0.12112676056338
200.17,2030,Single Family - Detached,734,711,23,0.0313351498637602
200.17,2035,Mobile Home,186,180,6,0.032258064516129
200.17,2035,Multifamily,710,624,86,0.12112676056338
200.17,2035,Single Family - Detached,804,781,23,0.0286069651741294
200.17,2040,Mobile Home,186,180,6,0.032258064516129
200.17,2040,Multifamily,710,623,87,0.122535211267606
200.17,2040,Single Family - Detached,840,811,29,0.0345238095238095
200.17,2045,Mobile Home,186,180,6,0.032258064516129
200.17,2045,Multifamily,710,618,92,0.129577464788732
200.17,2045,Single Family - Detached,840,808,32,0.0380952380952381
200.17,2050,Mobile Home,186,178,8,0.043010752688172
200.17,2050,Multifamily,710,618,92,0.129577464788732
200.17,2050,Single Family - Detached,840,807,33,0.0392857142857143
200.18,2012,Mobile Home,430,430,0,0
200.18,2012,Multifamily,686,684,2,0.00291545189504373
200.18,2012,Single Family - Detached,956,954,2,0.00209205020920502
200.18,2020,Mobile Home,430,430,0,0
200.18,2020,Multifamily,687,683,4,0.00582241630276565
200.18,2020,Single Family - Detached,1008,996,12,0.0119047619047619
200.18,2025,Mobile Home,430,429,1,0.00232558139534884
200.18,2025,Multifamily,692,680,12,0.0173410404624277
200.18,2025,Single Family - Detached,1088,1087,1,0.000919117647058824
200.18,2030,Mobile Home,430,425,5,0.0116279069767442
200.18,2030,Multifamily,756,743,13,0.0171957671957672
200.18,2030,Single Family - Detached,1081,1079,2,0.00185013876040703
200.18,2035,Mobile Home,430,426,4,0.00930232558139535
200.18,2035,Multifamily,756,736,20,0.0264550264550265
200.18,2035,Single Family - Detached,1083,1079,4,0.00369344413665743
200.18,2040,Mobile Home,430,430,0,0
200.18,2040,Multifamily,756,722,34,0.044973544973545
200.18,2040,Single Family - Detached,1083,1071,12,0.0110803324099723
200.18,2045,Mobile Home,430,424,6,0.013953488372093
200.18,2045,Multifamily,756,720,36,0.0476190476190476
200.18,2045,Single Family - Detached,1083,1052,31,0.0286241920590951
200.18,2050,Mobile Home,430,409,21,0.0488372093023256
200.18,2050,Multifamily,756,719,37,0.0489417989417989
200.18,2050,Single Family - Detached,1083,1045,38,0.0350877192982456
200.19,2012,Mobile Home,1300,1118,182,0.14
200.19,2012,Multifamily,329,418,-89,-0.270516717325228
200.19,2012,Single Family - Detached,1280,1275,5,0.00390625
200.19,2020,Mobile Home,1300,1122,178,0.136923076923077
200.19,2020,Multifamily,329,417,-88,-0.267477203647416
200.19,2020,Single Family - Detached,1284,1273,11,0.00856697819314642
200.19,2025,Mobile Home,1300,1122,178,0.136923076923077
200.19,2025,Multifamily,329,409,-80,-0.243161094224924
200.19,2025,Single Family - Detached,1277,1275,2,0.00156617071260767
200.19,2030,Mobile Home,1300,1120,180,0.138461538461538
200.19,2030,Multifamily,329,407,-78,-0.237082066869301
200.19,2030,Single Family - Detached,1330,1328,2,0.00150375939849624
200.19,2035,Mobile Home,1300,1120,180,0.138461538461538
200.19,2035,Multifamily,329,404,-75,-0.227963525835866
200.19,2035,Single Family - Detached,1355,1352,3,0.0022140221402214
200.19,2040,Mobile Home,1300,1125,175,0.134615384615385
200.19,2040,Multifamily,329,399,-70,-0.212765957446809
200.19,2040,Single Family - Detached,1355,1349,6,0.0044280442804428
200.19,2045,Mobile Home,1300,1121,179,0.137692307692308
200.19,2045,Multifamily,329,398,-69,-0.209726443768997
200.19,2045,Single Family - Detached,1355,1327,28,0.0206642066420664
200.19,2050,Mobile Home,1300,1111,189,0.145384615384615
200.19,2050,Multifamily,329,398,-69,-0.209726443768997
200.19,2050,Single Family - Detached,1355,1324,31,0.0228782287822878
20.02,2012,Mobile Home,0,0,0,
20.02,2012,Multifamily,284,259,25,0.0880281690140845
20.02,2012,Single Family - Detached,913,876,37,0.04052573932092
20.02,2020,Mobile Home,0,0,0,
20.02,2020,Multifamily,284,257,27,0.0950704225352113
20.02,2020,Single Family - Detached,915,877,38,0.0415300546448087
20.02,2025,Mobile Home,0,0,0,
20.02,2025,Multifamily,284,257,27,0.0950704225352113
20.02,2025,Single Family - Detached,915,878,37,0.0404371584699454
20.02,2030,Mobile Home,0,0,0,
20.02,2030,Multifamily,285,255,30,0.105263157894737
20.02,2030,Single Family - Detached,915,877,38,0.0415300546448087
20.02,2035,Mobile Home,0,0,0,
20.02,2035,Multifamily,289,259,30,0.103806228373702
20.02,2035,Single Family - Detached,911,873,38,0.0417124039517014
20.02,2040,Mobile Home,0,0,0,
20.02,2040,Multifamily,289,257,32,0.110726643598616
20.02,2040,Single Family - Detached,911,872,39,0.0428100987925357
20.02,2045,Mobile Home,0,0,0,
20.02,2045,Multifamily,289,256,33,0.114186851211073
20.02,2045,Single Family - Detached,911,871,40,0.0439077936333699
20.02,2050,Mobile Home,0,0,0,
20.02,2050,Multifamily,289,255,34,0.117647058823529
20.02,2050,Single Family - Detached,911,871,40,0.0439077936333699
200.20,2012,Mobile Home,0,0,0,
200.20,2012,Multifamily,0,0,0,
200.20,2012,Single Family - Detached,2077,2075,2,0.000962927298988926
200.20,2020,Mobile Home,0,0,0,
200.20,2020,Multifamily,0,0,0,
200.20,2020,Single Family - Detached,2211,2205,6,0.00271370420624152
200.20,2025,Mobile Home,0,0,0,
200.20,2025,Multifamily,0,0,0,
200.20,2025,Single Family - Detached,2236,2232,4,0.00178890876565295
200.20,2030,Mobile Home,0,0,0,
200.20,2030,Multifamily,0,0,0,
200.20,2030,Single Family - Detached,2236,2232,4,0.00178890876565295
200.20,2035,Mobile Home,0,0,0,
200.20,2035,Multifamily,0,0,0,
200.20,2035,Single Family - Detached,2236,2232,4,0.00178890876565295
200.20,2040,Mobile Home,0,0,0,
200.20,2040,Multifamily,0,0,0,
200.20,2040,Single Family - Detached,2236,2229,7,0.00313059033989267
200.20,2045,Mobile Home,0,0,0,
200.20,2045,Multifamily,0,0,0,
200.20,2045,Single Family - Detached,2236,2226,10,0.00447227191413238
200.20,2050,Mobile Home,0,0,0,
200.20,2050,Multifamily,0,0,0,
200.20,2050,Single Family - Detached,2252,2241,11,0.00488454706927176
200.21,2012,Mobile Home,0,0,0,
200.21,2012,Multifamily,646,642,4,0.00619195046439629
200.21,2012,Single Family - Detached,1009,1017,-8,-0.00792864222001982
200.21,2020,Mobile Home,0,0,0,
200.21,2020,Multifamily,731,731,0,0
200.21,2020,Single Family - Detached,1012,1017,-5,-0.00494071146245059
200.21,2025,Mobile Home,0,0,0,
200.21,2025,Multifamily,745,745,0,0
200.21,2025,Single Family - Detached,1009,1013,-4,-0.00396432111000991
200.21,2030,Mobile Home,0,0,0,
200.21,2030,Multifamily,751,751,0,0
200.21,2030,Single Family - Detached,1007,1011,-4,-0.00397219463753724
200.21,2035,Mobile Home,0,0,0,
200.21,2035,Multifamily,758,758,0,0
200.21,2035,Single Family - Detached,1006,1010,-4,-0.00397614314115308
200.21,2040,Mobile Home,0,0,0,
200.21,2040,Multifamily,849,847,2,0.00235571260306243
200.21,2040,Single Family - Detached,1006,1008,-2,-0.00198807157057654
200.21,2045,Mobile Home,0,0,0,
200.21,2045,Multifamily,873,871,2,0.00229095074455899
200.21,2045,Single Family - Detached,999,1001,-2,-0.002002002002002
200.21,2050,Mobile Home,0,0,0,
200.21,2050,Multifamily,888,886,2,0.00225225225225225
200.21,2050,Single Family - Detached,1015,1018,-3,-0.00295566502463054
200.22,2012,Mobile Home,0,0,0,
200.22,2012,Multifamily,578,552,26,0.0449826989619377
200.22,2012,Single Family - Detached,1878,1798,80,0.0425985090521832
200.22,2020,Mobile Home,0,0,0,
200.22,2020,Multifamily,578,552,26,0.0449826989619377
200.22,2020,Single Family - Detached,1878,1794,84,0.0447284345047923
200.22,2025,Mobile Home,0,0,0,
200.22,2025,Multifamily,578,554,24,0.041522491349481
200.22,2025,Single Family - Detached,1890,1819,71,0.0375661375661376
200.22,2030,Mobile Home,0,0,0,
200.22,2030,Multifamily,578,554,24,0.041522491349481
200.22,2030,Single Family - Detached,1890,1818,72,0.0380952380952381
200.22,2035,Mobile Home,0,0,0,
200.22,2035,Multifamily,578,554,24,0.041522491349481
200.22,2035,Single Family - Detached,1890,1824,66,0.0349206349206349
200.22,2040,Mobile Home,0,0,0,
200.22,2040,Multifamily,578,549,29,0.0501730103806228
200.22,2040,Single Family - Detached,1890,1814,76,0.0402116402116402
200.22,2045,Mobile Home,0,0,0,
200.22,2045,Multifamily,583,549,34,0.0583190394511149
200.22,2045,Single Family - Detached,1890,1809,81,0.0428571428571429
200.22,2050,Mobile Home,0,0,0,
200.22,2050,Multifamily,583,549,34,0.0583190394511149
200.22,2050,Single Family - Detached,1890,1804,86,0.0455026455026455
200.23,2012,Mobile Home,344,344,0,0
200.23,2012,Multifamily,2,0,2,1
200.23,2012,Single Family - Detached,893,889,4,0.00447928331466965
200.23,2020,Mobile Home,344,344,0,0
200.23,2020,Multifamily,3,3,0,0
200.23,2020,Single Family - Detached,893,886,7,0.00783874580067189
200.23,2025,Mobile Home,344,344,0,0
200.23,2025,Multifamily,4,4,0,0
200.23,2025,Single Family - Detached,895,890,5,0.00558659217877095
200.23,2030,Mobile Home,344,342,2,0.00581395348837209
200.23,2030,Multifamily,5,5,0,0
200.23,2030,Single Family - Detached,895,890,5,0.00558659217877095
200.23,2035,Mobile Home,344,342,2,0.00581395348837209
200.23,2035,Multifamily,5,5,0,0
200.23,2035,Single Family - Detached,895,890,5,0.00558659217877095
200.23,2040,Mobile Home,344,343,1,0.00290697674418605
200.23,2040,Multifamily,47,43,4,0.0851063829787234
200.23,2040,Single Family - Detached,902,888,14,0.0155210643015521
200.23,2045,Mobile Home,344,341,3,0.00872093023255814
200.23,2045,Multifamily,66,62,4,0.0606060606060606
200.23,2045,Single Family - Detached,902,886,16,0.0177383592017738
200.23,2050,Mobile Home,344,333,11,0.0319767441860465
200.23,2050,Multifamily,66,61,5,0.0757575757575758
200.23,2050,Single Family - Detached,903,888,15,0.0166112956810631
200.24,2012,Mobile Home,329,328,1,0.00303951367781155
200.24,2012,Multifamily,204,194,10,0.0490196078431373
200.24,2012,Single Family - Detached,968,921,47,0.0485537190082645
200.24,2020,Mobile Home,329,329,0,0
200.24,2020,Multifamily,204,194,10,0.0490196078431373
200.24,2020,Single Family - Detached,968,918,50,0.0516528925619835
200.24,2025,Mobile Home,329,329,0,0
200.24,2025,Multifamily,204,196,8,0.0392156862745098
200.24,2025,Single Family - Detached,968,923,45,0.0464876033057851
200.24,2030,Mobile Home,329,328,1,0.00303951367781155
200.24,2030,Multifamily,204,196,8,0.0392156862745098
200.24,2030,Single Family - Detached,968,923,45,0.0464876033057851
200.24,2035,Mobile Home,329,328,1,0.00303951367781155
200.24,2035,Multifamily,204,196,8,0.0392156862745098
200.24,2035,Single Family - Detached,968,924,44,0.0454545454545455
200.24,2040,Mobile Home,329,328,1,0.00303951367781155
200.24,2040,Multifamily,204,195,9,0.0441176470588235
200.24,2040,Single Family - Detached,968,917,51,0.0526859504132231
200.24,2045,Mobile Home,329,327,2,0.0060790273556231
200.24,2045,Multifamily,204,195,9,0.0441176470588235
200.24,2045,Single Family - Detached,977,923,54,0.0552712384851586
200.24,2050,Mobile Home,329,323,6,0.0182370820668693
200.24,2050,Multifamily,204,195,9,0.0441176470588235
200.24,2050,Single Family - Detached,983,927,56,0.0569684638860631
200.25,2012,Mobile Home,0,0,0,
200.25,2012,Multifamily,984,953,31,0.0315040650406504
200.25,2012,Single Family - Detached,829,776,53,0.0639324487334137
200.25,2020,Mobile Home,0,0,0,
200.25,2020,Multifamily,984,954,30,0.0304878048780488
200.25,2020,Single Family - Detached,830,779,51,0.0614457831325301
200.25,2025,Mobile Home,0,0,0,
200.25,2025,Multifamily,984,959,25,0.0254065040650406
200.25,2025,Single Family - Detached,841,797,44,0.0523186682520809
200.25,2030,Mobile Home,0,0,0,
200.25,2030,Multifamily,984,958,26,0.0264227642276423
200.25,2030,Single Family - Detached,859,814,45,0.0523864959254948
200.25,2035,Mobile Home,0,0,0,
200.25,2035,Multifamily,984,960,24,0.024390243902439
200.25,2035,Single Family - Detached,871,830,41,0.0470723306544202
200.25,2040,Mobile Home,0,0,0,
200.25,2040,Multifamily,1020,998,22,0.0215686274509804
200.25,2040,Single Family - Detached,901,885,16,0.0177580466148724
200.25,2045,Mobile Home,0,0,0,
200.25,2045,Multifamily,1041,1018,23,0.0220941402497598
200.25,2045,Single Family - Detached,901,883,18,0.0199778024417314
200.25,2050,Mobile Home,0,0,0,
200.25,2050,Multifamily,1041,1018,23,0.0220941402497598
200.25,2050,Single Family - Detached,901,881,20,0.0221975582685905
200.26,2012,Mobile Home,104,104,0,0
200.26,2012,Multifamily,254,233,21,0.0826771653543307
200.26,2012,Single Family - Detached,1460,1393,67,0.0458904109589041
200.26,2020,Mobile Home,104,104,0,0
200.26,2020,Multifamily,254,230,24,0.094488188976378
200.26,2020,Single Family - Detached,1461,1388,73,0.0499657768651608
200.26,2025,Mobile Home,104,103,1,0.00961538461538462
200.26,2025,Multifamily,2087,2029,58,0.0277910876856732
200.26,2025,Single Family - Detached,1459,1400,59,0.0404386566141193
200.26,2030,Mobile Home,104,100,4,0.0384615384615385
200.26,2030,Multifamily,2049,2008,41,0.0200097608589556
200.26,2030,Single Family - Detached,1460,1401,59,0.0404109589041096
200.26,2035,Mobile Home,104,101,3,0.0288461538461538
200.26,2035,Multifamily,2136,2094,42,0.0196629213483146
200.26,2035,Single Family - Detached,1409,1384,25,0.0177430801987225
200.26,2040,Mobile Home,104,102,2,0.0192307692307692
200.26,2040,Multifamily,2137,2139,-2,-0.000935891436593355
200.26,2040,Single Family - Detached,1436,1424,12,0.00835654596100279
200.26,2045,Mobile Home,104,100,4,0.0384615384615385
200.26,2045,Multifamily,2141,2139,2,0.000934142923867352
200.26,2045,Single Family - Detached,1438,1415,23,0.0159944367176634
200.26,2050,Mobile Home,104,92,12,0.115384615384615
200.26,2050,Multifamily,2141,2138,3,0.00140121438580103
200.26,2050,Single Family - Detached,1450,1427,23,0.0158620689655172
200.27,2012,Mobile Home,0,0,0,
200.27,2012,Multifamily,1329,1438,-109,-0.0820165537998495
200.27,2012,Single Family - Detached,3781,3481,300,0.0793440888653795
200.27,2020,Mobile Home,0,0,0,
200.27,2020,Multifamily,1600,1683,-83,-0.051875
200.27,2020,Single Family - Detached,4750,4418,332,0.0698947368421053
200.27,2025,Mobile Home,0,0,0,
200.27,2025,Multifamily,1601,1692,-91,-0.0568394753279201
200.27,2025,Single Family - Detached,4818,4523,295,0.0612287256122873
200.27,2030,Mobile Home,0,0,0,
200.27,2030,Multifamily,1812,1900,-88,-0.0485651214128035
200.27,2030,Single Family - Detached,4743,4448,295,0.0621969217794645
200.27,2035,Mobile Home,0,0,0,
200.27,2035,Multifamily,2292,2384,-92,-0.0401396160558464
200.27,2035,Single Family - Detached,4765,4477,288,0.0604407135362015
200.27,2040,Mobile Home,0,0,0,
200.27,2040,Multifamily,2160,2281,-121,-0.0560185185185185
200.27,2040,Single Family - Detached,4775,4510,265,0.0554973821989529
200.27,2045,Mobile Home,0,0,0,
200.27,2045,Multifamily,2160,2275,-115,-0.0532407407407407
200.27,2045,Single Family - Detached,4796,4556,240,0.0500417014178482
200.27,2050,Mobile Home,0,0,0,
200.27,2050,Multifamily,2160,2272,-112,-0.0518518518518519
200.27,2050,Single Family - Detached,4859,4617,242,0.0498044865198601
200.28,2012,Mobile Home,0,0,0,
200.28,2012,Multifamily,1047,985,62,0.0592168099331423
200.28,2012,Single Family - Detached,10,10,0,0
200.28,2020,Mobile Home,0,0,0,
200.28,2020,Multifamily,1063,1000,63,0.0592662276575729
200.28,2020,Single Family - Detached,10,8,2,0.2
200.28,2025,Mobile Home,0,0,0,
200.28,2025,Multifamily,1063,995,68,0.063969896519285
200.28,2025,Single Family - Detached,10,10,0,0
200.28,2030,Mobile Home,0,0,0,
200.28,2030,Multifamily,1063,993,70,0.0658513640639699
200.28,2030,Single Family - Detached,10,9,1,0.1
200.28,2035,Mobile Home,0,0,0,
200.28,2035,Multifamily,1065,1019,46,0.0431924882629108
200.28,2035,Single Family - Detached,10,8,2,0.2
200.28,2040,Mobile Home,0,0,0,
200.28,2040,Multifamily,1065,1010,55,0.0516431924882629
200.28,2040,Single Family - Detached,10,7,3,0.3
200.28,2045,Mobile Home,0,0,0,
200.28,2045,Multifamily,1065,1009,56,0.0525821596244131
200.28,2045,Single Family - Detached,10,5,5,0.5
200.28,2050,Mobile Home,0,0,0,
200.28,2050,Multifamily,1065,1009,56,0.0525821596244131
200.28,2050,Single Family - Detached,10,4,6,0.6
200.29,2012,Mobile Home,319,309,10,0.0313479623824451
200.29,2012,Multifamily,1713,1633,80,0.0467016929363689
200.29,2012,Single Family - Detached,56,61,-5,-0.0892857142857143
200.29,2020,Mobile Home,319,311,8,0.0250783699059561
200.29,2020,Multifamily,3019,2936,83,0.02749254720106
200.29,2020,Single Family - Detached,56,51,5,0.0892857142857143
200.29,2025,Mobile Home,319,310,9,0.0282131661442006
200.29,2025,Multifamily,3885,3783,102,0.0262548262548263
200.29,2025,Single Family - Detached,56,57,-1,-0.0178571428571429
200.29,2030,Mobile Home,319,305,14,0.0438871473354232
200.29,2030,Multifamily,3885,3774,111,0.0285714285714286
200.29,2030,Single Family - Detached,56,54,2,0.0357142857142857
200.29,2035,Mobile Home,319,306,13,0.0407523510971787
200.29,2035,Multifamily,3905,3785,120,0.030729833546735
200.29,2035,Single Family - Detached,49,42,7,0.142857142857143
200.29,2040,Mobile Home,238,238,0,0
200.29,2040,Multifamily,4772,4603,169,0.0354149203688181
200.29,2040,Single Family - Detached,49,34,15,0.306122448979592
200.29,2045,Mobile Home,226,222,4,0.0176991150442478
200.29,2045,Multifamily,4730,4561,169,0.0357293868921776
200.29,2045,Single Family - Detached,48,27,21,0.4375
200.29,2050,Mobile Home,226,212,14,0.0619469026548673
200.29,2050,Multifamily,4550,4381,169,0.0371428571428571
200.29,2050,Single Family - Detached,48,24,24,0.5
2.01,2012,Mobile Home,0,0,0,
2.01,2012,Multifamily,507,500,7,0.0138067061143984
2.01,2012,Single Family - Detached,609,554,55,0.090311986863711
2.01,2020,Mobile Home,0,0,0,
2.01,2020,Multifamily,557,551,6,0.0107719928186715
2.01,2020,Single Family - Detached,614,592,22,0.0358306188925081
2.01,2025,Mobile Home,0,0,0,
2.01,2025,Multifamily,739,725,14,0.0189445196211096
2.01,2025,Single Family - Detached,593,574,19,0.0320404721753794
2.01,2030,Mobile Home,0,0,0,
2.01,2030,Multifamily,855,836,19,0.0222222222222222
2.01,2030,Single Family - Detached,593,570,23,0.0387858347386172
2.01,2035,Mobile Home,0,0,0,
2.01,2035,Multifamily,855,834,21,0.0245614035087719
2.01,2035,Single Family - Detached,593,570,23,0.0387858347386172
2.01,2040,Mobile Home,0,0,0,
2.01,2040,Multifamily,855,827,28,0.0327485380116959
2.01,2040,Single Family - Detached,593,569,24,0.0404721753794266
2.01,2045,Mobile Home,0,0,0,
2.01,2045,Multifamily,855,813,42,0.0491228070175439
2.01,2045,Single Family - Detached,593,564,29,0.0489038785834739
2.01,2050,Mobile Home,0,0,0,
2.01,2050,Multifamily,855,801,54,0.0631578947368421
2.01,2050,Single Family - Detached,594,564,30,0.0505050505050505
201.03,2012,Mobile Home,110,94,16,0.145454545454545
201.03,2012,Multifamily,2,0,2,1
201.03,2012,Single Family - Detached,3452,3358,94,0.0272305909617613
201.03,2020,Mobile Home,110,95,15,0.136363636363636
201.03,2020,Multifamily,2,2,0,0
201.03,2020,Single Family - Detached,3838,3712,126,0.0328295987493486
201.03,2025,Mobile Home,110,95,15,0.136363636363636
201.03,2025,Multifamily,2,2,0,0
201.03,2025,Single Family - Detached,3995,3899,96,0.0240300375469337
201.03,2030,Mobile Home,110,93,17,0.154545454545455
201.03,2030,Multifamily,2,2,0,0
201.03,2030,Single Family - Detached,4104,3990,114,0.0277777777777778
201.03,2035,Mobile Home,110,93,17,0.154545454545455
201.03,2035,Multifamily,2,2,0,0
201.03,2035,Single Family - Detached,4129,4017,112,0.0271252119157181
201.03,2040,Mobile Home,110,93,17,0.154545454545455
201.03,2040,Multifamily,47,46,1,0.0212765957446809
201.03,2040,Single Family - Detached,4192,4084,108,0.025763358778626
201.03,2045,Mobile Home,110,91,19,0.172727272727273
201.03,2045,Multifamily,47,46,1,0.0212765957446809
201.03,2045,Single Family - Detached,4192,4047,145,0.0345896946564885
201.03,2050,Mobile Home,110,87,23,0.209090909090909
201.03,2050,Multifamily,47,46,1,0.0212765957446809
201.03,2050,Single Family - Detached,4193,4036,157,0.0374433579775817
201.05,2012,Mobile Home,0,0,0,
201.05,2012,Multifamily,645,543,102,0.158139534883721
201.05,2012,Single Family - Detached,903,877,26,0.0287929125138427
201.05,2020,Mobile Home,0,0,0,
201.05,2020,Multifamily,645,546,99,0.153488372093023
201.05,2020,Single Family - Detached,1009,989,20,0.0198216055500496
201.05,2025,Mobile Home,0,0,0,
201.05,2025,Multifamily,645,547,98,0.151937984496124
201.05,2025,Single Family - Detached,1137,1120,17,0.0149516270888303
201.05,2030,Mobile Home,0,0,0,
201.05,2030,Multifamily,645,547,98,0.151937984496124
201.05,2030,Single Family - Detached,1160,1146,14,0.0120689655172414
201.05,2035,Mobile Home,0,0,0,
201.05,2035,Multifamily,645,548,97,0.150387596899225
201.05,2035,Single Family - Detached,1160,1147,13,0.0112068965517241
201.05,2040,Mobile Home,0,0,0,
201.05,2040,Multifamily,645,547,98,0.151937984496124
201.05,2040,Single Family - Detached,1160,1141,19,0.0163793103448276
201.05,2045,Mobile Home,0,0,0,
201.05,2045,Multifamily,645,547,98,0.151937984496124
201.05,2045,Single Family - Detached,1160,1141,19,0.0163793103448276
201.05,2050,Mobile Home,0,0,0,
201.05,2050,Multifamily,645,547,98,0.151937984496124
201.05,2050,Single Family - Detached,1160,1141,19,0.0163793103448276
201.06,2012,Mobile Home,88,88,0,0
201.06,2012,Multifamily,168,159,9,0.0535714285714286
201.06,2012,Single Family - Detached,921,907,14,0.0152008686210641
201.06,2020,Mobile Home,88,88,0,0
201.06,2020,Multifamily,168,161,7,0.0416666666666667
201.06,2020,Single Family - Detached,924,901,23,0.0248917748917749
201.06,2025,Mobile Home,88,88,0,0
201.06,2025,Multifamily,168,162,6,0.0357142857142857
201.06,2025,Single Family - Detached,924,909,15,0.0162337662337662
201.06,2030,Mobile Home,88,87,1,0.0113636363636364
201.06,2030,Multifamily,168,162,6,0.0357142857142857
201.06,2030,Single Family - Detached,955,946,9,0.00942408376963351
201.06,2035,Mobile Home,88,87,1,0.0113636363636364
201.06,2035,Multifamily,168,162,6,0.0357142857142857
201.06,2035,Single Family - Detached,966,956,10,0.010351966873706
201.06,2040,Mobile Home,88,88,0,0
201.06,2040,Multifamily,168,162,6,0.0357142857142857
201.06,2040,Single Family - Detached,966,941,25,0.025879917184265
201.06,2045,Mobile Home,88,87,1,0.0113636363636364
201.06,2045,Multifamily,168,162,6,0.0357142857142857
201.06,2045,Single Family - Detached,966,941,25,0.025879917184265
201.06,2050,Mobile Home,88,85,3,0.0340909090909091
201.06,2050,Multifamily,168,162,6,0.0357142857142857
201.06,2050,Single Family - Detached,966,941,25,0.025879917184265
201.07,2012,Mobile Home,260,230,30,0.115384615384615
201.07,2012,Multifamily,0,0,0,
201.07,2012,Single Family - Detached,934,929,5,0.00535331905781585
201.07,2020,Mobile Home,260,231,29,0.111538461538462
201.07,2020,Multifamily,0,0,0,
201.07,2020,Single Family - Detached,1011,996,15,0.0148367952522255
201.07,2025,Mobile Home,260,231,29,0.111538461538462
201.07,2025,Multifamily,0,0,0,
201.07,2025,Single Family - Detached,1020,1009,11,0.0107843137254902
201.07,2030,Mobile Home,260,230,30,0.115384615384615
201.07,2030,Multifamily,0,0,0,
201.07,2030,Single Family - Detached,1020,1008,12,0.0117647058823529
201.07,2035,Mobile Home,260,230,30,0.115384615384615
201.07,2035,Multifamily,0,0,0,
201.07,2035,Single Family - Detached,1072,1058,14,0.0130597014925373
201.07,2040,Mobile Home,260,230,30,0.115384615384615
201.07,2040,Multifamily,0,0,0,
201.07,2040,Single Family - Detached,1083,1063,20,0.0184672206832872
201.07,2045,Mobile Home,260,229,31,0.119230769230769
201.07,2045,Multifamily,0,0,0,
201.07,2045,Single Family - Detached,1083,1059,24,0.0221606648199446
201.07,2050,Mobile Home,260,225,35,0.134615384615385
201.07,2050,Multifamily,0,0,0,
201.07,2050,Single Family - Detached,1083,1059,24,0.0221606648199446
201.08,2012,Mobile Home,0,0,0,
201.08,2012,Multifamily,1084,1080,4,0.003690036900369
201.08,2012,Single Family - Detached,591,566,25,0.0423011844331641
201.08,2020,Mobile Home,0,0,0,
201.08,2020,Multifamily,1084,1078,6,0.00553505535055351
201.08,2020,Single Family - Detached,600,575,25,0.0416666666666667
201.08,2025,Mobile Home,0,0,0,
201.08,2025,Multifamily,1092,1091,1,0.000915750915750916
201.08,2025,Single Family - Detached,601,581,20,0.0332778702163062
201.08,2030,Mobile Home,0,0,0,
201.08,2030,Multifamily,1098,1096,2,0.00182149362477231
201.08,2030,Single Family - Detached,602,581,21,0.0348837209302326
201.08,2035,Mobile Home,0,0,0,
201.08,2035,Multifamily,1102,1102,0,0
201.08,2035,Single Family - Detached,611,592,19,0.0310965630114566
201.08,2040,Mobile Home,0,0,0,
201.08,2040,Multifamily,1105,1105,0,0
201.08,2040,Single Family - Detached,615,593,22,0.0357723577235772
201.08,2045,Mobile Home,0,0,0,
201.08,2045,Multifamily,1107,1106,1,0.000903342366757001
201.08,2045,Single Family - Detached,615,587,28,0.0455284552845528
201.08,2050,Mobile Home,0,0,0,
201.08,2050,Multifamily,1107,1105,2,0.001806684733514
201.08,2050,Single Family - Detached,615,587,28,0.0455284552845528
201.09,2012,Mobile Home,0,0,0,
201.09,2012,Multifamily,1,0,1,1
201.09,2012,Single Family - Detached,1330,1281,49,0.0368421052631579
201.09,2020,Mobile Home,0,0,0,
201.09,2020,Multifamily,1,0,1,1
201.09,2020,Single Family - Detached,1330,1279,51,0.0383458646616541
201.09,2025,Mobile Home,0,0,0,
201.09,2025,Multifamily,1,1,0,0
201.09,2025,Single Family - Detached,1330,1284,46,0.0345864661654135
201.09,2030,Mobile Home,0,0,0,
201.09,2030,Multifamily,1,0,1,1
201.09,2030,Single Family - Detached,1330,1284,46,0.0345864661654135
201.09,2035,Mobile Home,0,0,0,
201.09,2035,Multifamily,1,1,0,0
201.09,2035,Single Family - Detached,1330,1286,44,0.0330827067669173
201.09,2040,Mobile Home,0,0,0,
201.09,2040,Multifamily,1,1,0,0
201.09,2040,Single Family - Detached,1339,1299,40,0.0298730395817774
201.09,2045,Mobile Home,0,0,0,
201.09,2045,Multifamily,1,0,1,1
201.09,2045,Single Family - Detached,1339,1295,44,0.0328603435399552
201.09,2050,Mobile Home,0,0,0,
201.09,2050,Multifamily,1,0,1,1
201.09,2050,Single Family - Detached,1339,1294,45,0.0336071695294996
2.02,2012,Mobile Home,0,0,0,
2.02,2012,Multifamily,1078,1009,69,0.0640074211502783
2.02,2012,Single Family - Detached,1315,1253,62,0.047148288973384
2.02,2020,Mobile Home,0,0,0,
2.02,2020,Multifamily,1074,1006,68,0.0633147113594041
2.02,2020,Single Family - Detached,1323,1250,73,0.055177626606198
2.02,2025,Mobile Home,0,0,0,
2.02,2025,Multifamily,1176,1118,58,0.0493197278911565
2.02,2025,Single Family - Detached,1316,1250,66,0.0501519756838906
2.02,2030,Mobile Home,0,0,0,
2.02,2030,Multifamily,1513,1448,65,0.0429610046265697
2.02,2030,Single Family - Detached,1294,1243,51,0.0394126738794436
2.02,2035,Mobile Home,0,0,0,
2.02,2035,Multifamily,1759,1702,57,0.0324047754405912
2.02,2035,Single Family - Detached,1234,1187,47,0.0380875202593193
2.02,2040,Mobile Home,0,0,0,
2.02,2040,Multifamily,1819,1758,61,0.0335349092908191
2.02,2040,Single Family - Detached,1229,1179,50,0.0406834825061025
2.02,2045,Mobile Home,0,0,0,
2.02,2045,Multifamily,1961,1913,48,0.0244773074961754
2.02,2045,Single Family - Detached,1213,1179,34,0.0280296784830998
2.02,2050,Mobile Home,0,0,0,
2.02,2050,Multifamily,1975,1915,60,0.030379746835443
2.02,2050,Single Family - Detached,1214,1181,33,0.0271828665568369
202.02,2012,Mobile Home,0,0,0,
202.02,2012,Multifamily,1266,1112,154,0.121642969984202
202.02,2012,Single Family - Detached,548,522,26,0.0474452554744526
202.02,2020,Mobile Home,0,0,0,
202.02,2020,Multifamily,1267,1105,162,0.127861089187056
202.02,2020,Single Family - Detached,546,516,30,0.0549450549450549
202.02,2025,Mobile Home,0,0,0,
202.02,2025,Multifamily,1418,1272,146,0.10296191819464
202.02,2025,Single Family - Detached,493,478,15,0.0304259634888438
202.02,2030,Mobile Home,0,0,0,
202.02,2030,Multifamily,1493,1348,145,0.0971198928332217
202.02,2030,Single Family - Detached,468,454,14,0.0299145299145299
202.02,2035,Mobile Home,0,0,0,
202.02,2035,Multifamily,1529,1387,142,0.0928711576193591
202.02,2035,Single Family - Detached,454,445,9,0.0198237885462555
202.02,2040,Mobile Home,0,0,0,
202.02,2040,Multifamily,1531,1410,121,0.0790333115610712
202.02,2040,Single Family - Detached,454,441,13,0.0286343612334802
202.02,2045,Mobile Home,0,0,0,
202.02,2045,Multifamily,1531,1407,124,0.0809928151534944
202.02,2045,Single Family - Detached,454,436,18,0.039647577092511
202.02,2050,Mobile Home,0,0,0,
202.02,2050,Multifamily,1531,1407,124,0.0809928151534944
202.02,2050,Single Family - Detached,454,435,19,0.0418502202643172
202.06,2012,Mobile Home,0,0,0,
202.06,2012,Multifamily,482,461,21,0.0435684647302905
202.06,2012,Single Family - Detached,797,770,27,0.0338770388958595
202.06,2020,Mobile Home,0,0,0,
202.06,2020,Multifamily,482,460,22,0.045643153526971
202.06,2020,Single Family - Detached,797,768,29,0.0363864491844417
202.06,2025,Mobile Home,0,0,0,
202.06,2025,Multifamily,482,462,20,0.04149377593361
202.06,2025,Single Family - Detached,797,777,20,0.0250941028858218
202.06,2030,Mobile Home,0,0,0,
202.06,2030,Multifamily,482,462,20,0.04149377593361
202.06,2030,Single Family - Detached,797,777,20,0.0250941028858218
202.06,2035,Mobile Home,0,0,0,
202.06,2035,Multifamily,495,475,20,0.0404040404040404
202.06,2035,Single Family - Detached,791,772,19,0.0240202275600506
202.06,2040,Mobile Home,0,0,0,
202.06,2040,Multifamily,537,521,16,0.0297951582867784
202.06,2040,Single Family - Detached,771,750,21,0.0272373540856031
202.06,2045,Mobile Home,0,0,0,
202.06,2045,Multifamily,537,520,17,0.031657355679702
202.06,2045,Single Family - Detached,771,748,23,0.0298313878080415
202.06,2050,Mobile Home,0,0,0,
202.06,2050,Multifamily,537,520,17,0.031657355679702
202.06,2050,Single Family - Detached,771,747,24,0.0311284046692607
202.07,2012,Mobile Home,137,86,51,0.372262773722628
202.07,2012,Multifamily,942,891,51,0.054140127388535
202.07,2012,Single Family - Detached,359,351,8,0.0222841225626741
202.07,2020,Mobile Home,137,88,49,0.357664233576642
202.07,2020,Multifamily,942,890,52,0.0552016985138004
202.07,2020,Single Family - Detached,359,346,13,0.0362116991643454
202.07,2025,Mobile Home,137,88,49,0.357664233576642
202.07,2025,Multifamily,942,899,43,0.0456475583864119
202.07,2025,Single Family - Detached,359,349,10,0.0278551532033426
202.07,2030,Mobile Home,137,86,51,0.372262773722628
202.07,2030,Multifamily,942,896,46,0.0488322717622081
202.07,2030,Single Family - Detached,359,348,11,0.0306406685236769
202.07,2035,Mobile Home,137,86,51,0.372262773722628
202.07,2035,Multifamily,942,900,42,0.0445859872611465
202.07,2035,Single Family - Detached,359,348,11,0.0306406685236769
202.07,2040,Mobile Home,137,87,50,0.364963503649635
202.07,2040,Multifamily,942,911,31,0.0329087048832272
202.07,2040,Single Family - Detached,359,345,14,0.0389972144846797
202.07,2045,Mobile Home,137,86,51,0.372262773722628
202.07,2045,Multifamily,976,940,36,0.0368852459016393
202.07,2045,Single Family - Detached,339,334,5,0.0147492625368732
202.07,2050,Mobile Home,137,81,56,0.408759124087591
202.07,2050,Multifamily,976,938,38,0.0389344262295082
202.07,2050,Single Family - Detached,339,333,6,0.0176991150442478
202.08,2012,Mobile Home,0,0,0,
202.08,2012,Multifamily,24,24,0,0
202.08,2012,Single Family - Detached,642,622,20,0.0311526479750779
202.08,2020,Mobile Home,0,0,0,
202.08,2020,Multifamily,24,23,1,0.0416666666666667
202.08,2020,Single Family - Detached,642,622,20,0.0311526479750779
202.08,2025,Mobile Home,0,0,0,
202.08,2025,Multifamily,24,24,0,0
202.08,2025,Single Family - Detached,642,624,18,0.0280373831775701
202.08,2030,Mobile Home,0,0,0,
202.08,2030,Multifamily,24,24,0,0
202.08,2030,Single Family - Detached,642,624,18,0.0280373831775701
202.08,2035,Mobile Home,0,0,0,
202.08,2035,Multifamily,24,24,0,0
202.08,2035,Single Family - Detached,642,624,18,0.0280373831775701
202.08,2040,Mobile Home,0,0,0,
202.08,2040,Multifamily,24,24,0,0
202.08,2040,Single Family - Detached,649,630,19,0.0292758089368259
202.08,2045,Mobile Home,0,0,0,
202.08,2045,Multifamily,24,23,1,0.0416666666666667
202.08,2045,Single Family - Detached,649,628,21,0.0323574730354391
202.08,2050,Mobile Home,0,0,0,
202.08,2050,Multifamily,24,23,1,0.0416666666666667
202.08,2050,Single Family - Detached,649,628,21,0.0323574730354391
202.09,2012,Mobile Home,589,551,38,0.0645161290322581
202.09,2012,Multifamily,1027,977,50,0.0486854917234664
202.09,2012,Single Family - Detached,281,275,6,0.0213523131672598
202.09,2020,Mobile Home,589,552,37,0.0628183361629881
202.09,2020,Multifamily,1027,975,52,0.0506329113924051
202.09,2020,Single Family - Detached,281,272,9,0.0320284697508897
202.09,2025,Mobile Home,589,552,37,0.0628183361629881
202.09,2025,Multifamily,1027,980,47,0.0457643622200584
202.09,2025,Single Family - Detached,281,275,6,0.0213523131672598
202.09,2030,Mobile Home,589,550,39,0.066213921901528
202.09,2030,Multifamily,1027,979,48,0.0467380720545277
202.09,2030,Single Family - Detached,281,274,7,0.0249110320284698
202.09,2035,Mobile Home,589,550,39,0.066213921901528
202.09,2035,Multifamily,1027,980,47,0.0457643622200584
202.09,2035,Single Family - Detached,281,275,6,0.0213523131672598
202.09,2040,Mobile Home,589,550,39,0.066213921901528
202.09,2040,Multifamily,1028,986,42,0.0408560311284047
202.09,2040,Single Family - Detached,281,272,9,0.0320284697508897
202.09,2045,Mobile Home,589,548,41,0.0696095076400679
202.09,2045,Multifamily,1029,985,44,0.0427599611273081
202.09,2045,Single Family - Detached,281,270,11,0.0391459074733096
202.09,2050,Mobile Home,589,539,50,0.0848896434634974
202.09,2050,Multifamily,1029,984,45,0.043731778425656
202.09,2050,Single Family - Detached,281,269,12,0.0427046263345196
202.10,2012,Mobile Home,443,411,32,0.072234762979684
202.10,2012,Multifamily,573,573,0,0
202.10,2012,Single Family - Detached,678,639,39,0.0575221238938053
202.10,2020,Mobile Home,443,412,31,0.0699774266365688
202.10,2020,Multifamily,573,571,2,0.00349040139616056
202.10,2020,Single Family - Detached,683,642,41,0.0600292825768668
202.10,2025,Mobile Home,443,412,31,0.0699774266365688
202.10,2025,Multifamily,573,573,0,0
202.10,2025,Single Family - Detached,683,645,38,0.0556368960468521
202.10,2030,Mobile Home,443,411,32,0.072234762979684
202.10,2030,Multifamily,573,572,1,0.00174520069808028
202.10,2030,Single Family - Detached,683,645,38,0.0556368960468521
202.10,2035,Mobile Home,443,411,32,0.072234762979684
202.10,2035,Multifamily,573,573,0,0
202.10,2035,Single Family - Detached,683,645,38,0.0556368960468521
202.10,2040,Mobile Home,443,411,32,0.072234762979684
202.10,2040,Multifamily,573,573,0,0
202.10,2040,Single Family - Detached,698,658,40,0.0573065902578797
202.10,2045,Mobile Home,443,410,33,0.0744920993227991
202.10,2045,Multifamily,573,571,2,0.00349040139616056
202.10,2045,Single Family - Detached,698,658,40,0.0573065902578797
202.10,2050,Mobile Home,443,406,37,0.0835214446952596
202.10,2050,Multifamily,573,571,2,0.00349040139616056
202.10,2050,Single Family - Detached,733,693,40,0.0545702592087312
202.11,2012,Mobile Home,86,86,0,0
202.11,2012,Multifamily,1412,1213,199,0.140934844192635
202.11,2012,Single Family - Detached,776,729,47,0.0605670103092784
202.11,2020,Mobile Home,86,86,0,0
202.11,2020,Multifamily,1412,1209,203,0.143767705382436
202.11,2020,Single Family - Detached,776,724,52,0.0670103092783505
202.11,2025,Mobile Home,86,85,1,0.0116279069767442
202.11,2025,Multifamily,1412,1222,190,0.134560906515581
202.11,2025,Single Family - Detached,776,734,42,0.0541237113402062
202.11,2030,Mobile Home,86,83,3,0.0348837209302326
202.11,2030,Multifamily,1412,1219,193,0.136685552407932
202.11,2030,Single Family - Detached,776,732,44,0.0567010309278351
202.11,2035,Mobile Home,86,84,2,0.0232558139534884
202.11,2035,Multifamily,1413,1226,187,0.132342533616419
202.11,2035,Single Family - Detached,776,739,37,0.047680412371134
202.11,2040,Mobile Home,86,85,1,0.0116279069767442
202.11,2040,Multifamily,1414,1253,161,0.113861386138614
202.11,2040,Single Family - Detached,778,748,30,0.038560411311054
202.11,2045,Mobile Home,86,84,2,0.0232558139534884
202.11,2045,Multifamily,1414,1249,165,0.116690240452617
202.11,2045,Single Family - Detached,778,744,34,0.0437017994858612
202.11,2050,Mobile Home,86,79,7,0.0813953488372093
202.11,2050,Multifamily,1414,1249,165,0.116690240452617
202.11,2050,Single Family - Detached,778,742,36,0.0462724935732648
202.13,2012,Mobile Home,0,0,0,
202.13,2012,Multifamily,816,749,67,0.0821078431372549
202.13,2012,Single Family - Detached,250,239,11,0.044
202.13,2020,Mobile Home,0,0,0,
202.13,2020,Multifamily,816,748,68,0.0833333333333333
202.13,2020,Single Family - Detached,250,239,11,0.044
202.13,2025,Mobile Home,0,0,0,
202.13,2025,Multifamily,964,921,43,0.0446058091286307
202.13,2025,Single Family - Detached,207,204,3,0.0144927536231884
202.13,2030,Mobile Home,0,0,0,
202.13,2030,Multifamily,964,921,43,0.0446058091286307
202.13,2030,Single Family - Detached,207,204,3,0.0144927536231884
202.13,2035,Mobile Home,0,0,0,
202.13,2035,Multifamily,964,921,43,0.0446058091286307
202.13,2035,Single Family - Detached,207,204,3,0.0144927536231884
202.13,2040,Mobile Home,0,0,0,
202.13,2040,Multifamily,964,926,38,0.0394190871369295
202.13,2040,Single Family - Detached,207,203,4,0.0193236714975845
202.13,2045,Mobile Home,0,0,0,
202.13,2045,Multifamily,964,926,38,0.0394190871369295
202.13,2045,Single Family - Detached,207,203,4,0.0193236714975845
202.13,2050,Mobile Home,0,0,0,
202.13,2050,Multifamily,964,926,38,0.0394190871369295
202.13,2050,Single Family - Detached,207,203,4,0.0193236714975845
202.14,2012,Mobile Home,0,0,0,
202.14,2012,Multifamily,1406,1349,57,0.0405405405405405
202.14,2012,Single Family - Detached,186,176,10,0.0537634408602151
202.14,2020,Mobile Home,0,0,0,
202.14,2020,Multifamily,4259,4006,253,0.0594036158722705
202.14,2020,Single Family - Detached,186,170,16,0.0860215053763441
202.14,2025,Mobile Home,0,0,0,
202.14,2025,Multifamily,4995,4746,249,0.0498498498498499
202.14,2025,Single Family - Detached,107,104,3,0.0280373831775701
202.14,2030,Mobile Home,0,0,0,
202.14,2030,Multifamily,4995,4746,249,0.0498498498498499
202.14,2030,Single Family - Detached,106,104,2,0.0188679245283019
202.14,2035,Mobile Home,0,0,0,
202.14,2035,Multifamily,4996,4749,247,0.049439551641313
202.14,2035,Single Family - Detached,105,105,0,0
202.14,2040,Mobile Home,0,0,0,
202.14,2040,Multifamily,4997,4772,225,0.0450270162097258
202.14,2040,Single Family - Detached,105,103,2,0.019047619047619
202.14,2045,Mobile Home,0,0,0,
202.14,2045,Multifamily,4997,4770,227,0.0454272563538123
202.14,2045,Single Family - Detached,105,101,4,0.0380952380952381
202.14,2050,Mobile Home,0,0,0,
202.14,2050,Multifamily,4997,4770,227,0.0454272563538123
202.14,2050,Single Family - Detached,105,101,4,0.0380952380952381
203.04,2012,Mobile Home,155,154,1,0.00645161290322581
203.04,2012,Multifamily,0,0,0,
203.04,2012,Single Family - Detached,2268,2195,73,0.0321869488536155
203.04,2020,Mobile Home,155,155,0,0
203.04,2020,Multifamily,0,0,0,
203.04,2020,Single Family - Detached,2322,2241,81,0.0348837209302326
203.04,2025,Mobile Home,155,153,2,0.0129032258064516
203.04,2025,Multifamily,0,0,0,
203.04,2025,Single Family - Detached,2333,2266,67,0.0287183883411916
203.04,2030,Mobile Home,155,150,5,0.032258064516129
203.04,2030,Multifamily,0,0,0,
203.04,2030,Single Family - Detached,2333,2263,70,0.0300042863266181
203.04,2035,Mobile Home,155,152,3,0.0193548387096774
203.04,2035,Multifamily,0,0,0,
203.04,2035,Single Family - Detached,2333,2268,65,0.0278611230175739
203.04,2040,Mobile Home,155,154,1,0.00645161290322581
203.04,2040,Multifamily,0,0,0,
203.04,2040,Single Family - Detached,2373,2297,76,0.0320269700800674
203.04,2045,Mobile Home,155,152,3,0.0193548387096774
203.04,2045,Multifamily,0,0,0,
203.04,2045,Single Family - Detached,2414,2329,85,0.0352112676056338
203.04,2050,Mobile Home,155,145,10,0.0645161290322581
203.04,2050,Multifamily,0,0,0,
203.04,2050,Single Family - Detached,2475,2384,91,0.0367676767676768
203.05,2012,Mobile Home,232,232,0,0
203.05,2012,Multifamily,543,431,112,0.206261510128913
203.05,2012,Single Family - Detached,1553,1513,40,0.025756600128783
203.05,2020,Mobile Home,232,232,0,0
203.05,2020,Multifamily,543,430,113,0.208103130755064
203.05,2020,Single Family - Detached,1598,1544,54,0.0337922403003755
203.05,2025,Mobile Home,232,232,0,0
203.05,2025,Multifamily,543,443,100,0.184162062615101
203.05,2025,Single Family - Detached,1598,1559,39,0.0244055068836045
203.05,2030,Mobile Home,232,229,3,0.0129310344827586
203.05,2030,Multifamily,543,443,100,0.184162062615101
203.05,2030,Single Family - Detached,1598,1558,40,0.0250312891113892
203.05,2035,Mobile Home,232,229,3,0.0129310344827586
203.05,2035,Multifamily,543,445,98,0.180478821362799
203.05,2035,Single Family - Detached,1598,1565,33,0.0206508135168961
203.05,2040,Mobile Home,232,230,2,0.00862068965517241
203.05,2040,Multifamily,543,443,100,0.184162062615101
203.05,2040,Single Family - Detached,1604,1574,30,0.0187032418952618
203.05,2045,Mobile Home,232,227,5,0.021551724137931
203.05,2045,Multifamily,543,443,100,0.184162062615101
203.05,2045,Single Family - Detached,1604,1572,32,0.0199501246882793
203.05,2050,Mobile Home,232,218,14,0.0603448275862069
203.05,2050,Multifamily,543,442,101,0.186003683241252
203.05,2050,Single Family - Detached,1608,1568,40,0.0248756218905473
203.06,2012,Mobile Home,691,669,22,0.0318379160636758
203.06,2012,Multifamily,1727,1628,99,0.0573248407643312
203.06,2012,Single Family - Detached,1058,955,103,0.0973534971644612
203.06,2020,Mobile Home,691,672,19,0.0274963820549928
203.06,2020,Multifamily,2786,2650,136,0.0488155061019383
203.06,2020,Single Family - Detached,1550,1420,130,0.0838709677419355
203.06,2025,Mobile Home,691,672,19,0.0274963820549928
203.06,2025,Multifamily,2787,2661,126,0.0452099031216362
203.06,2025,Single Family - Detached,1796,1676,120,0.066815144766147
203.06,2030,Mobile Home,691,670,21,0.0303907380607815
203.06,2030,Multifamily,2788,2658,130,0.0466284074605452
203.06,2030,Single Family - Detached,1834,1711,123,0.0670665212649945
203.06,2035,Mobile Home,691,670,21,0.0303907380607815
203.06,2035,Multifamily,2789,2666,123,0.0441018286124059
203.06,2035,Single Family - Detached,1840,1722,118,0.0641304347826087
203.06,2040,Mobile Home,691,671,20,0.0289435600578871
203.06,2040,Multifamily,3401,3361,40,0.0117612466921494
203.06,2040,Single Family - Detached,1843,1747,96,0.0520889853499729
203.06,2045,Mobile Home,691,669,22,0.0318379160636758
203.06,2045,Multifamily,3401,3357,44,0.0129373713613643
203.06,2045,Single Family - Detached,1843,1742,101,0.0548019533369506
203.06,2050,Mobile Home,691,662,29,0.0419681620839363
203.06,2050,Multifamily,3401,3356,45,0.013231402528668
203.06,2050,Single Family - Detached,1845,1742,103,0.0558265582655827
203.07,2012,Mobile Home,901,886,15,0.0166481687014428
203.07,2012,Multifamily,526,507,19,0.0361216730038023
203.07,2012,Single Family - Detached,1332,1300,32,0.024024024024024
203.07,2020,Mobile Home,901,887,14,0.0155382907880133
203.07,2020,Multifamily,577,561,16,0.0277296360485269
203.07,2020,Single Family - Detached,1412,1378,34,0.0240793201133144
203.07,2025,Mobile Home,901,886,15,0.0166481687014428
203.07,2025,Multifamily,767,750,17,0.0221642764015645
203.07,2025,Single Family - Detached,1562,1527,35,0.0224071702944942
203.07,2030,Mobile Home,901,882,19,0.0210876803551609
203.07,2030,Multifamily,829,810,19,0.02291917973462
203.07,2030,Single Family - Detached,1833,1791,42,0.0229132569558101
203.07,2035,Mobile Home,901,882,19,0.0210876803551609
203.07,2035,Multifamily,953,934,19,0.0199370409233998
203.07,2035,Single Family - Detached,2148,2104,44,0.0204841713221601
203.07,2040,Mobile Home,901,884,17,0.0188679245283019
203.07,2040,Multifamily,1000,976,24,0.024
203.07,2040,Single Family - Detached,2256,2208,48,0.0212765957446809
203.07,2045,Mobile Home,901,880,21,0.02330743618202
203.07,2045,Multifamily,1057,1029,28,0.0264900662251656
203.07,2045,Single Family - Detached,2329,2276,53,0.0227565478746243
203.07,2050,Mobile Home,901,863,38,0.0421753607103219
203.07,2050,Multifamily,1057,1028,29,0.0274361400189215
203.07,2050,Single Family - Detached,2332,2279,53,0.0227272727272727
203.08,2012,Mobile Home,603,586,17,0.0281923714759536
203.08,2012,Multifamily,2025,1928,97,0.0479012345679012
203.08,2012,Single Family - Detached,153,153,0,0
203.08,2020,Mobile Home,603,588,15,0.0248756218905473
203.08,2020,Multifamily,2025,1926,99,0.0488888888888889
203.08,2020,Single Family - Detached,153,151,2,0.0130718954248366
203.08,2025,Mobile Home,603,588,15,0.0248756218905473
203.08,2025,Multifamily,2025,1938,87,0.042962962962963
203.08,2025,Single Family - Detached,153,153,0,0
203.08,2030,Mobile Home,603,587,16,0.0265339966832504
203.08,2030,Multifamily,2025,1938,87,0.042962962962963
203.08,2030,Single Family - Detached,153,153,0,0
203.08,2035,Mobile Home,603,587,16,0.0265339966832504
203.08,2035,Multifamily,2025,1939,86,0.0424691358024691
203.08,2035,Single Family - Detached,153,153,0,0
203.08,2040,Mobile Home,603,587,16,0.0265339966832504
203.08,2040,Multifamily,2025,1937,88,0.0434567901234568
203.08,2040,Single Family - Detached,153,153,0,0
203.08,2045,Mobile Home,603,587,16,0.0265339966832504
203.08,2045,Multifamily,2025,1936,89,0.0439506172839506
203.08,2045,Single Family - Detached,153,153,0,0
203.08,2050,Mobile Home,603,582,21,0.0348258706467662
203.08,2050,Multifamily,2025,1935,90,0.0444444444444444
203.08,2050,Single Family - Detached,153,151,2,0.0130718954248366
203.09,2012,Mobile Home,0,0,0,
203.09,2012,Multifamily,475,475,0,0
203.09,2012,Single Family - Detached,755,726,29,0.0384105960264901
203.09,2020,Mobile Home,0,0,0,
203.09,2020,Multifamily,476,475,1,0.00210084033613445
203.09,2020,Single Family - Detached,809,771,38,0.0469715698393078
203.09,2025,Mobile Home,0,0,0,
203.09,2025,Multifamily,481,481,0,0
203.09,2025,Single Family - Detached,1003,975,28,0.0279162512462612
203.09,2030,Mobile Home,0,0,0,
203.09,2030,Multifamily,481,481,0,0
203.09,2030,Single Family - Detached,1017,987,30,0.0294985250737463
203.09,2035,Mobile Home,0,0,0,
203.09,2035,Multifamily,481,481,0,0
203.09,2035,Single Family - Detached,1037,1011,26,0.0250723240115718
203.09,2040,Mobile Home,0,0,0,
203.09,2040,Multifamily,481,478,3,0.00623700623700624
203.09,2040,Single Family - Detached,1119,1085,34,0.0303842716711349
203.09,2045,Mobile Home,0,0,0,
203.09,2045,Multifamily,481,478,3,0.00623700623700624
203.09,2045,Single Family - Detached,1119,1083,36,0.032171581769437
203.09,2050,Mobile Home,0,0,0,
203.09,2050,Multifamily,481,478,3,0.00623700623700624
203.09,2050,Single Family - Detached,1228,1199,29,0.0236156351791531
204.01,2012,Mobile Home,0,0,0,
204.01,2012,Multifamily,0,0,0,
204.01,2012,Single Family - Detached,958,954,4,0.00417536534446764
204.01,2020,Mobile Home,0,0,0,
204.01,2020,Multifamily,0,0,0,
204.01,2020,Single Family - Detached,980,973,7,0.00714285714285714
204.01,2025,Mobile Home,0,0,0,
204.01,2025,Multifamily,0,0,0,
204.01,2025,Single Family - Detached,999,995,4,0.004004004004004
204.01,2030,Mobile Home,0,0,0,
204.01,2030,Multifamily,0,0,0,
204.01,2030,Single Family - Detached,1034,1029,5,0.00483558994197292
204.01,2035,Mobile Home,0,0,0,
204.01,2035,Multifamily,0,0,0,
204.01,2035,Single Family - Detached,1064,1060,4,0.0037593984962406
204.01,2040,Mobile Home,0,0,0,
204.01,2040,Multifamily,0,0,0,
204.01,2040,Single Family - Detached,1071,1063,8,0.00746965452847806
204.01,2045,Mobile Home,0,0,0,
204.01,2045,Multifamily,0,0,0,
204.01,2045,Single Family - Detached,1071,1059,12,0.0112044817927171
204.01,2050,Mobile Home,0,0,0,
204.01,2050,Multifamily,0,0,0,
204.01,2050,Single Family - Detached,1072,1058,14,0.0130597014925373
204.03,2012,Mobile Home,130,130,0,0
204.03,2012,Multifamily,68,53,15,0.220588235294118
204.03,2012,Single Family - Detached,1064,1069,-5,-0.00469924812030075
204.03,2020,Mobile Home,130,130,0,0
204.03,2020,Multifamily,68,46,22,0.323529411764706
204.03,2020,Single Family - Detached,1119,1120,-1,-0.000893655049151028
204.03,2025,Mobile Home,130,130,0,0
204.03,2025,Multifamily,111,90,21,0.189189189189189
204.03,2025,Single Family - Detached,1157,1161,-4,-0.00345721694036301
204.03,2030,Mobile Home,130,129,1,0.00769230769230769
204.03,2030,Multifamily,129,106,23,0.178294573643411
204.03,2030,Single Family - Detached,1173,1176,-3,-0.00255754475703325
204.03,2035,Mobile Home,130,129,1,0.00769230769230769
204.03,2035,Multifamily,156,136,20,0.128205128205128
204.03,2035,Single Family - Detached,1166,1170,-4,-0.00343053173241852
204.03,2040,Mobile Home,130,129,1,0.00769230769230769
204.03,2040,Multifamily,99,77,22,0.222222222222222
204.03,2040,Single Family - Detached,1166,1167,-1,-0.000857632933104631
204.03,2045,Mobile Home,130,128,2,0.0153846153846154
204.03,2045,Multifamily,214,191,23,0.107476635514019
204.03,2045,Single Family - Detached,1166,1166,0,0
204.03,2050,Mobile Home,130,125,5,0.0384615384615385
204.03,2050,Multifamily,156,132,24,0.153846153846154
204.03,2050,Single Family - Detached,1213,1210,3,0.00247320692497939
204.04,2012,Mobile Home,104,101,3,0.0288461538461538
204.04,2012,Multifamily,756,752,4,0.00529100529100529
204.04,2012,Single Family - Detached,1072,1025,47,0.0438432835820896
204.04,2020,Mobile Home,104,102,2,0.0192307692307692
204.04,2020,Multifamily,756,745,11,0.0145502645502645
204.04,2020,Single Family - Detached,1131,1081,50,0.0442086648983201
204.04,2025,Mobile Home,104,101,3,0.0288461538461538
204.04,2025,Multifamily,756,746,10,0.0132275132275132
204.04,2025,Single Family - Detached,1139,1096,43,0.0377524143985953
204.04,2030,Mobile Home,104,100,4,0.0384615384615385
204.04,2030,Multifamily,756,746,10,0.0132275132275132
204.04,2030,Single Family - Detached,1171,1125,46,0.0392826643894108
204.04,2035,Mobile Home,104,100,4,0.0384615384615385
204.04,2035,Multifamily,756,746,10,0.0132275132275132
204.04,2035,Single Family - Detached,1173,1131,42,0.0358056265984655
204.04,2040,Mobile Home,104,101,3,0.0288461538461538
204.04,2040,Multifamily,756,746,10,0.0132275132275132
204.04,2040,Single Family - Detached,1179,1134,45,0.0381679389312977
204.04,2045,Mobile Home,104,100,4,0.0384615384615385
204.04,2045,Multifamily,757,745,12,0.0158520475561427
204.04,2045,Single Family - Detached,1179,1132,47,0.0398642917726887
204.04,2050,Mobile Home,104,97,7,0.0673076923076923
204.04,2050,Multifamily,757,745,12,0.0158520475561427
204.04,2050,Single Family - Detached,1184,1134,50,0.0422297297297297
204.05,2012,Mobile Home,0,0,0,
204.05,2012,Multifamily,0,0,0,
204.05,2012,Single Family - Detached,1297,1292,5,0.0038550501156515
204.05,2020,Mobile Home,0,0,0,
204.05,2020,Multifamily,0,0,0,
204.05,2020,Single Family - Detached,1395,1386,9,0.00645161290322581
204.05,2025,Mobile Home,0,0,0,
204.05,2025,Multifamily,0,0,0,
204.05,2025,Single Family - Detached,1449,1443,6,0.0041407867494824
204.05,2030,Mobile Home,0,0,0,
204.05,2030,Multifamily,0,0,0,
204.05,2030,Single Family - Detached,1592,1587,5,0.00314070351758794
204.05,2035,Mobile Home,0,0,0,
204.05,2035,Multifamily,0,0,0,
204.05,2035,Single Family - Detached,1636,1631,5,0.00305623471882641
204.05,2040,Mobile Home,0,0,0,
204.05,2040,Multifamily,0,0,0,
204.05,2040,Single Family - Detached,1636,1630,6,0.00366748166259169
204.05,2045,Mobile Home,0,0,0,
204.05,2045,Multifamily,0,0,0,
204.05,2045,Single Family - Detached,1637,1628,9,0.00549786194257789
204.05,2050,Mobile Home,0,0,0,
204.05,2050,Multifamily,0,0,0,
204.05,2050,Single Family - Detached,1639,1630,9,0.00549115314215985
205,2012,Mobile Home,77,72,5,0.0649350649350649
205,2012,Multifamily,388,345,43,0.110824742268041
205,2012,Single Family - Detached,1041,1007,34,0.0326609029779059
205,2020,Mobile Home,77,73,4,0.051948051948052
205,2020,Multifamily,388,336,52,0.134020618556701
205,2020,Single Family - Detached,1042,997,45,0.0431861804222649
205,2025,Mobile Home,77,73,4,0.051948051948052
205,2025,Multifamily,392,332,60,0.153061224489796
205,2025,Single Family - Detached,1043,1004,39,0.037392138063279
205,2030,Mobile Home,77,73,4,0.051948051948052
205,2030,Multifamily,392,331,61,0.155612244897959
205,2030,Single Family - Detached,1044,1004,40,0.0383141762452107
205,2035,Mobile Home,77,73,4,0.051948051948052
205,2035,Multifamily,392,344,48,0.122448979591837
205,2035,Single Family - Detached,1045,1006,39,0.0373205741626794
205,2040,Mobile Home,77,73,4,0.051948051948052
205,2040,Multifamily,392,359,33,0.0841836734693878
205,2040,Single Family - Detached,1046,1024,22,0.0210325047801147
205,2045,Mobile Home,77,73,4,0.051948051948052
205,2045,Multifamily,392,345,47,0.119897959183673
205,2045,Single Family - Detached,1046,1020,26,0.0248565965583174
205,2050,Mobile Home,77,72,5,0.0649350649350649
205,2050,Multifamily,392,344,48,0.122448979591837
205,2050,Single Family - Detached,1047,1020,27,0.0257879656160458
206.01,2012,Mobile Home,0,0,0,
206.01,2012,Multifamily,521,459,62,0.119001919385797
206.01,2012,Single Family - Detached,1024,1006,18,0.017578125
206.01,2020,Mobile Home,0,0,0,
206.01,2020,Multifamily,2045,1888,157,0.0767726161369193
206.01,2020,Single Family - Detached,1019,1004,15,0.014720314033366
206.01,2025,Mobile Home,0,0,0,
206.01,2025,Multifamily,2259,2101,158,0.0699424524125719
206.01,2025,Single Family - Detached,1003,995,8,0.00797607178464606
206.01,2030,Mobile Home,0,0,0,
206.01,2030,Multifamily,2260,2099,161,0.0712389380530973
206.01,2030,Single Family - Detached,1003,995,8,0.00797607178464606
206.01,2035,Mobile Home,0,0,0,
206.01,2035,Multifamily,2261,2113,148,0.0654577620521893
206.01,2035,Single Family - Detached,996,996,0,0
206.01,2040,Mobile Home,0,0,0,
206.01,2040,Multifamily,2322,2200,122,0.0525409130060293
206.01,2040,Single Family - Detached,972,969,3,0.00308641975308642
206.01,2045,Mobile Home,0,0,0,
206.01,2045,Multifamily,2366,2232,134,0.0566356720202874
206.01,2045,Single Family - Detached,957,948,9,0.00940438871473354
206.01,2050,Mobile Home,0,0,0,
206.01,2050,Multifamily,2366,2228,138,0.0583262890955199
206.01,2050,Single Family - Detached,957,945,12,0.0125391849529781
206.02,2012,Mobile Home,0,0,0,
206.02,2012,Multifamily,599,591,8,0.013355592654424
206.02,2012,Single Family - Detached,1467,1386,81,0.0552147239263804
206.02,2020,Mobile Home,0,0,0,
206.02,2020,Multifamily,599,576,23,0.0383973288814691
206.02,2020,Single Family - Detached,1559,1474,85,0.0545221295702373
206.02,2025,Mobile Home,0,0,0,
206.02,2025,Multifamily,599,557,42,0.0701168614357262
206.02,2025,Single Family - Detached,1559,1476,83,0.0532392559332906
206.02,2030,Mobile Home,0,0,0,
206.02,2030,Multifamily,599,554,45,0.0751252086811352
206.02,2030,Single Family - Detached,1559,1476,83,0.0532392559332906
206.02,2035,Mobile Home,0,0,0,
206.02,2035,Multifamily,599,556,43,0.0717863105175292
206.02,2035,Single Family - Detached,1558,1476,82,0.0526315789473684
206.02,2040,Mobile Home,0,0,0,
206.02,2040,Multifamily,599,573,26,0.0434056761268781
206.02,2040,Single Family - Detached,1558,1476,82,0.0526315789473684
206.02,2045,Mobile Home,0,0,0,
206.02,2045,Multifamily,601,571,30,0.0499168053244592
206.02,2045,Single Family - Detached,1557,1475,82,0.0526653821451509
206.02,2050,Mobile Home,0,0,0,
206.02,2050,Multifamily,601,571,30,0.0499168053244592
206.02,2050,Single Family - Detached,1557,1475,82,0.0526653821451509
207.05,2012,Mobile Home,0,0,0,
207.05,2012,Multifamily,1,0,1,1
207.05,2012,Single Family - Detached,1447,1426,21,0.0145127850725639
207.05,2020,Mobile Home,0,0,0,
207.05,2020,Multifamily,1,0,1,1
207.05,2020,Single Family - Detached,1495,1470,25,0.0167224080267559
207.05,2025,Mobile Home,0,0,0,
207.05,2025,Multifamily,1,1,0,0
207.05,2025,Single Family - Detached,1570,1560,10,0.00636942675159236
207.05,2030,Mobile Home,0,0,0,
207.05,2030,Multifamily,1,0,1,1
207.05,2030,Single Family - Detached,1653,1643,10,0.00604960677555959
207.05,2035,Mobile Home,0,0,0,
207.05,2035,Multifamily,1,1,0,0
207.05,2035,Single Family - Detached,1760,1751,9,0.00511363636363636
207.05,2040,Mobile Home,0,0,0,
207.05,2040,Multifamily,1,1,0,0
207.05,2040,Single Family - Detached,1799,1784,15,0.00833796553640912
207.05,2045,Mobile Home,0,0,0,
207.05,2045,Multifamily,1,0,1,1
207.05,2045,Single Family - Detached,1821,1797,24,0.0131795716639209
207.05,2050,Mobile Home,0,0,0,
207.05,2050,Multifamily,1,0,1,1
207.05,2050,Single Family - Detached,1823,1797,26,0.0142622051563357
207.06,2012,Mobile Home,0,0,0,
207.06,2012,Multifamily,119,87,32,0.26890756302521
207.06,2012,Single Family - Detached,2082,2066,16,0.00768491834774256
207.06,2020,Mobile Home,0,0,0,
207.06,2020,Multifamily,119,88,31,0.260504201680672
207.06,2020,Single Family - Detached,2129,2097,32,0.0150305307656177
207.06,2025,Mobile Home,0,0,0,
207.06,2025,Multifamily,119,89,30,0.252100840336134
207.06,2025,Single Family - Detached,2155,2133,22,0.0102088167053364
207.06,2030,Mobile Home,0,0,0,
207.06,2030,Multifamily,119,88,31,0.260504201680672
207.06,2030,Single Family - Detached,2184,2161,23,0.0105311355311355
207.06,2035,Mobile Home,0,0,0,
207.06,2035,Multifamily,119,89,30,0.252100840336134
207.06,2035,Single Family - Detached,2224,2210,14,0.00629496402877698
207.06,2040,Mobile Home,0,0,0,
207.06,2040,Multifamily,119,89,30,0.252100840336134
207.06,2040,Single Family - Detached,2237,2215,22,0.00983459991059455
207.06,2045,Mobile Home,0,0,0,
207.06,2045,Multifamily,119,88,31,0.260504201680672
207.06,2045,Single Family - Detached,2238,2209,29,0.0129579982126899
207.06,2050,Mobile Home,0,0,0,
207.06,2050,Multifamily,119,88,31,0.260504201680672
207.06,2050,Single Family - Detached,2243,2212,31,0.0138207757467677
207.07,2012,Mobile Home,0,0,0,
207.07,2012,Multifamily,888,826,62,0.0698198198198198
207.07,2012,Single Family - Detached,702,684,18,0.0256410256410256
207.07,2020,Mobile Home,0,0,0,
207.07,2020,Multifamily,889,852,37,0.0416197975253093
207.07,2020,Single Family - Detached,702,682,20,0.0284900284900285
207.07,2025,Mobile Home,0,0,0,
207.07,2025,Multifamily,889,857,32,0.0359955005624297
207.07,2025,Single Family - Detached,702,686,16,0.0227920227920228
207.07,2030,Mobile Home,0,0,0,
207.07,2030,Multifamily,889,857,32,0.0359955005624297
207.07,2030,Single Family - Detached,702,686,16,0.0227920227920228
207.07,2035,Mobile Home,0,0,0,
207.07,2035,Multifamily,889,857,32,0.0359955005624297
207.07,2035,Single Family - Detached,702,687,15,0.0213675213675214
207.07,2040,Mobile Home,0,0,0,
207.07,2040,Multifamily,889,856,33,0.0371203599550056
207.07,2040,Single Family - Detached,702,685,17,0.0242165242165242
207.07,2045,Mobile Home,0,0,0,
207.07,2045,Multifamily,889,851,38,0.0427446569178853
207.07,2045,Single Family - Detached,702,684,18,0.0256410256410256
207.07,2050,Mobile Home,0,0,0,
207.07,2050,Multifamily,888,851,37,0.0416666666666667
207.07,2050,Single Family - Detached,687,672,15,0.0218340611353712
207.08,2012,Mobile Home,89,81,8,0.0898876404494382
207.08,2012,Multifamily,183,183,0,0
207.08,2012,Single Family - Detached,971,914,57,0.05870236869207
207.08,2020,Mobile Home,89,82,7,0.0786516853932584
207.08,2020,Multifamily,258,255,3,0.0116279069767442
207.08,2020,Single Family - Detached,1015,966,49,0.0482758620689655
207.08,2025,Mobile Home,89,82,7,0.0786516853932584
207.08,2025,Multifamily,258,256,2,0.00775193798449612
207.08,2025,Single Family - Detached,1018,972,46,0.0451866404715128
207.08,2030,Mobile Home,89,82,7,0.0786516853932584
207.08,2030,Multifamily,258,256,2,0.00775193798449612
207.08,2030,Single Family - Detached,1018,971,47,0.0461689587426326
207.08,2035,Mobile Home,89,82,7,0.0786516853932584
207.08,2035,Multifamily,258,257,1,0.00387596899224806
207.08,2035,Single Family - Detached,1018,970,48,0.0471512770137525
207.08,2040,Mobile Home,89,82,7,0.0786516853932584
207.08,2040,Multifamily,258,256,2,0.00775193798449612
207.08,2040,Single Family - Detached,1018,969,49,0.0481335952848723
207.08,2045,Mobile Home,89,82,7,0.0786516853932584
207.08,2045,Multifamily,299,297,2,0.00668896321070234
207.08,2045,Single Family - Detached,1018,968,50,0.0491159135559921
207.08,2050,Mobile Home,89,80,9,0.101123595505618
207.08,2050,Multifamily,294,292,2,0.00680272108843537
207.08,2050,Single Family - Detached,1028,977,51,0.0496108949416342
207.09,2012,Mobile Home,90,90,0,0
207.09,2012,Multifamily,5,5,0,0
207.09,2012,Single Family - Detached,2524,2486,38,0.0150554675118859
207.09,2020,Mobile Home,90,90,0,0
207.09,2020,Multifamily,5,5,0,0
207.09,2020,Single Family - Detached,2926,2876,50,0.0170881749829118
207.09,2025,Mobile Home,90,90,0,0
207.09,2025,Multifamily,5,5,0,0
207.09,2025,Single Family - Detached,2946,2906,40,0.0135777325186694
207.09,2030,Mobile Home,90,90,0,0
207.09,2030,Multifamily,5,4,1,0.2
207.09,2030,Single Family - Detached,2967,2924,43,0.0144927536231884
207.09,2035,Mobile Home,90,90,0,0
207.09,2035,Multifamily,5,5,0,0
207.09,2035,Single Family - Detached,3004,2962,42,0.0139813581890812
207.09,2040,Mobile Home,90,90,0,0
207.09,2040,Multifamily,5,5,0,0
207.09,2040,Single Family - Detached,3030,2987,43,0.0141914191419142
207.09,2045,Mobile Home,90,90,0,0
207.09,2045,Multifamily,5,5,0,0
207.09,2045,Single Family - Detached,3058,3009,49,0.0160235448005232
207.09,2050,Mobile Home,90,89,1,0.0111111111111111
207.09,2050,Multifamily,5,4,1,0.2
207.09,2050,Single Family - Detached,3061,3014,47,0.0153544593270173
207.10,2012,Mobile Home,0,0,0,
207.10,2012,Multifamily,0,3,-3,
207.10,2012,Single Family - Detached,701,696,5,0.00713266761768902
207.10,2020,Mobile Home,0,0,0,
207.10,2020,Multifamily,0,0,0,
207.10,2020,Single Family - Detached,709,701,8,0.0112834978843441
207.10,2025,Mobile Home,0,0,0,
207.10,2025,Multifamily,0,0,0,
207.10,2025,Single Family - Detached,712,707,5,0.00702247191011236
207.10,2030,Mobile Home,0,0,0,
207.10,2030,Multifamily,0,0,0,
207.10,2030,Single Family - Detached,715,709,6,0.00839160839160839
207.10,2035,Mobile Home,0,0,0,
207.10,2035,Multifamily,0,0,0,
207.10,2035,Single Family - Detached,721,716,5,0.00693481276005548
207.10,2040,Mobile Home,0,0,0,
207.10,2040,Multifamily,0,0,0,
207.10,2040,Single Family - Detached,721,715,6,0.00832177531206657
207.10,2045,Mobile Home,0,0,0,
207.10,2045,Multifamily,0,0,0,
207.10,2045,Single Family - Detached,721,714,7,0.00970873786407767
207.10,2050,Mobile Home,0,0,0,
207.10,2050,Multifamily,0,0,0,
207.10,2050,Single Family - Detached,721,714,7,0.00970873786407767
208.01,2012,Mobile Home,4,4,0,0
208.01,2012,Multifamily,184,184,0,0
208.01,2012,Single Family - Detached,1680,1669,11,0.00654761904761905
208.01,2020,Mobile Home,4,4,0,0
208.01,2020,Multifamily,184,184,0,0
208.01,2020,Single Family - Detached,1835,1818,17,0.00926430517711172
208.01,2025,Mobile Home,4,3,1,0.25
208.01,2025,Multifamily,184,184,0,0
208.01,2025,Single Family - Detached,1871,1857,14,0.00748262960983431
208.01,2030,Mobile Home,4,4,0,0
208.01,2030,Multifamily,184,184,0,0
208.01,2030,Single Family - Detached,1922,1908,14,0.0072840790842872
208.01,2035,Mobile Home,4,4,0,0
208.01,2035,Multifamily,184,184,0,0
208.01,2035,Single Family - Detached,2095,2082,13,0.00620525059665871
208.01,2040,Mobile Home,4,4,0,0
208.01,2040,Multifamily,184,184,0,0
208.01,2040,Single Family - Detached,2133,2117,16,0.00750117205813408
208.01,2045,Mobile Home,4,3,1,0.25
208.01,2045,Multifamily,184,184,0,0
208.01,2045,Single Family - Detached,2170,2151,19,0.00875576036866359
208.01,2050,Mobile Home,4,3,1,0.25
208.01,2050,Multifamily,184,184,0,0
208.01,2050,Single Family - Detached,2319,2302,17,0.00733074601121173
208.05,2012,Mobile Home,0,0,0,
208.05,2012,Multifamily,295,273,22,0.0745762711864407
208.05,2012,Single Family - Detached,822,822,0,0
208.05,2020,Mobile Home,0,0,0,
208.05,2020,Multifamily,295,289,6,0.0203389830508475
208.05,2020,Single Family - Detached,839,827,12,0.0143027413587604
208.05,2025,Mobile Home,0,0,0,
208.05,2025,Multifamily,273,268,5,0.0183150183150183
208.05,2025,Single Family - Detached,844,834,10,0.0118483412322275
208.05,2030,Mobile Home,0,0,0,
208.05,2030,Multifamily,279,275,4,0.014336917562724
208.05,2030,Single Family - Detached,855,840,15,0.0175438596491228
208.05,2035,Mobile Home,0,0,0,
208.05,2035,Multifamily,279,275,4,0.014336917562724
208.05,2035,Single Family - Detached,862,849,13,0.0150812064965197
208.05,2040,Mobile Home,0,0,0,
208.05,2040,Multifamily,352,344,8,0.0227272727272727
208.05,2040,Single Family - Detached,865,846,19,0.0219653179190751
208.05,2045,Mobile Home,0,0,0,
208.05,2045,Multifamily,404,394,10,0.0247524752475248
208.05,2045,Single Family - Detached,883,860,23,0.0260475651189128
208.05,2050,Mobile Home,0,0,0,
208.05,2050,Multifamily,404,394,10,0.0247524752475248
208.05,2050,Single Family - Detached,884,861,23,0.0260180995475113
208.06,2012,Mobile Home,286,273,13,0.0454545454545455
208.06,2012,Multifamily,807,764,43,0.0532837670384139
208.06,2012,Single Family - Detached,970,950,20,0.0206185567010309
208.06,2020,Mobile Home,286,274,12,0.041958041958042
208.06,2020,Multifamily,837,791,46,0.0549581839904421
208.06,2020,Single Family - Detached,1034,1019,15,0.0145067698259188
208.06,2025,Mobile Home,286,274,12,0.041958041958042
208.06,2025,Multifamily,838,799,39,0.0465393794749403
208.06,2025,Single Family - Detached,1185,1179,6,0.00506329113924051
208.06,2030,Mobile Home,286,272,14,0.048951048951049
208.06,2030,Multifamily,857,816,41,0.0478413068844807
208.06,2030,Single Family - Detached,1254,1246,8,0.00637958532695375
208.06,2035,Mobile Home,286,272,14,0.048951048951049
208.06,2035,Multifamily,857,816,41,0.0478413068844807
208.06,2035,Single Family - Detached,1271,1265,6,0.004720692368214
208.06,2040,Mobile Home,286,273,13,0.0454545454545455
208.06,2040,Multifamily,898,861,37,0.0412026726057906
208.06,2040,Single Family - Detached,1291,1281,10,0.00774593338497289
208.06,2045,Mobile Home,286,272,14,0.048951048951049
208.06,2045,Multifamily,1025,978,47,0.0458536585365854
208.06,2045,Single Family - Detached,1332,1320,12,0.00900900900900901
208.06,2050,Mobile Home,286,267,19,0.0664335664335664
208.06,2050,Multifamily,1025,978,47,0.0458536585365854
208.06,2050,Single Family - Detached,1336,1324,12,0.00898203592814371
208.07,2012,Mobile Home,192,186,6,0.03125
208.07,2012,Multifamily,0,0,0,
208.07,2012,Single Family - Detached,861,861,0,0
208.07,2020,Mobile Home,192,187,5,0.0260416666666667
208.07,2020,Multifamily,0,0,0,
208.07,2020,Single Family - Detached,924,901,23,0.0248917748917749
208.07,2025,Mobile Home,192,187,5,0.0260416666666667
208.07,2025,Multifamily,0,0,0,
208.07,2025,Single Family - Detached,933,908,25,0.0267952840300107
208.07,2030,Mobile Home,192,186,6,0.03125
208.07,2030,Multifamily,0,0,0,
208.07,2030,Single Family - Detached,948,919,29,0.0305907172995781
208.07,2035,Mobile Home,192,186,6,0.03125
208.07,2035,Multifamily,0,0,0,
208.07,2035,Single Family - Detached,980,952,28,0.0285714285714286
208.07,2040,Mobile Home,192,186,6,0.03125
208.07,2040,Multifamily,0,0,0,
208.07,2040,Single Family - Detached,980,943,37,0.0377551020408163
208.07,2045,Mobile Home,192,186,6,0.03125
208.07,2045,Multifamily,0,0,0,
208.07,2045,Single Family - Detached,983,936,47,0.0478128179043744
208.07,2050,Mobile Home,192,182,10,0.0520833333333333
208.07,2050,Multifamily,0,0,0,
208.07,2050,Single Family - Detached,983,933,50,0.0508646998982706
208.09,2012,Mobile Home,0,0,0,
208.09,2012,Multifamily,279,253,26,0.0931899641577061
208.09,2012,Single Family - Detached,1880,1856,24,0.0127659574468085
208.09,2020,Mobile Home,0,0,0,
208.09,2020,Multifamily,261,223,38,0.145593869731801
208.09,2020,Single Family - Detached,2132,2104,28,0.0131332082551595
208.09,2025,Mobile Home,0,0,0,
208.09,2025,Multifamily,261,228,33,0.126436781609195
208.09,2025,Single Family - Detached,2173,2147,26,0.0119650253106305
208.09,2030,Mobile Home,0,0,0,
208.09,2030,Multifamily,261,227,34,0.130268199233716
208.09,2030,Single Family - Detached,2371,2349,22,0.00927878532264867
208.09,2035,Mobile Home,0,0,0,
208.09,2035,Multifamily,261,228,33,0.126436781609195
208.09,2035,Single Family - Detached,2541,2519,22,0.00865800865800866
208.09,2040,Mobile Home,0,0,0,
208.09,2040,Multifamily,261,216,45,0.172413793103448
208.09,2040,Single Family - Detached,2621,2599,22,0.00839374284624189
208.09,2045,Mobile Home,0,0,0,
208.09,2045,Multifamily,377,320,57,0.151193633952255
208.09,2045,Single Family - Detached,2705,2679,26,0.00961182994454714
208.09,2050,Mobile Home,0,0,0,
208.09,2050,Multifamily,377,319,58,0.153846153846154
208.09,2050,Single Family - Detached,2746,2718,28,0.0101966496722505
208.10,2012,Mobile Home,0,0,0,
208.10,2012,Multifamily,0,0,0,
208.10,2012,Single Family - Detached,1778,1748,30,0.0168728908886389
208.10,2020,Mobile Home,0,0,0,
208.10,2020,Multifamily,0,0,0,
208.10,2020,Single Family - Detached,1953,1938,15,0.00768049155145929
208.10,2025,Mobile Home,0,0,0,
208.10,2025,Multifamily,0,0,0,
208.10,2025,Single Family - Detached,1966,1951,15,0.00762970498474059
208.10,2030,Mobile Home,0,0,0,
208.10,2030,Multifamily,0,0,0,
208.10,2030,Single Family - Detached,1991,1975,16,0.00803616273229533
208.10,2035,Mobile Home,0,0,0,
208.10,2035,Multifamily,0,0,0,
208.10,2035,Single Family - Detached,2075,2060,15,0.0072289156626506
208.10,2040,Mobile Home,0,0,0,
208.10,2040,Multifamily,0,0,0,
208.10,2040,Single Family - Detached,2075,2057,18,0.00867469879518072
208.10,2045,Mobile Home,0,0,0,
208.10,2045,Multifamily,0,0,0,
208.10,2045,Single Family - Detached,2075,2053,22,0.0106024096385542
208.10,2050,Mobile Home,0,0,0,
208.10,2050,Multifamily,0,0,0,
208.10,2050,Single Family - Detached,2075,2051,24,0.011566265060241
208.11,2012,Mobile Home,0,0,0,
208.11,2012,Multifamily,0,0,0,
208.11,2012,Single Family - Detached,2132,2002,130,0.0609756097560976
208.11,2020,Mobile Home,0,0,0,
208.11,2020,Multifamily,0,0,0,
208.11,2020,Single Family - Detached,2158,2014,144,0.0667284522706209
208.11,2025,Mobile Home,0,0,0,
208.11,2025,Multifamily,0,0,0,
208.11,2025,Single Family - Detached,2160,2054,106,0.0490740740740741
208.11,2030,Mobile Home,0,0,0,
208.11,2030,Multifamily,0,0,0,
208.11,2030,Single Family - Detached,2160,2053,107,0.049537037037037
208.11,2035,Mobile Home,0,0,0,
208.11,2035,Multifamily,0,0,0,
208.11,2035,Single Family - Detached,2304,2200,104,0.0451388888888889
208.11,2040,Mobile Home,0,0,0,
208.11,2040,Multifamily,0,0,0,
208.11,2040,Single Family - Detached,2316,2209,107,0.0462003454231434
208.11,2045,Mobile Home,0,0,0,
208.11,2045,Multifamily,0,0,0,
208.11,2045,Single Family - Detached,2324,2214,110,0.0473321858864028
208.11,2050,Mobile Home,0,0,0,
208.11,2050,Multifamily,0,0,0,
208.11,2050,Single Family - Detached,2326,2216,110,0.0472914875322442
209.02,2012,Mobile Home,0,0,0,
209.02,2012,Multifamily,8,7,1,0.125
209.02,2012,Single Family - Detached,1080,935,145,0.134259259259259
209.02,2020,Mobile Home,0,0,0,
209.02,2020,Multifamily,8,7,1,0.125
209.02,2020,Single Family - Detached,1164,987,177,0.152061855670103
209.02,2025,Mobile Home,0,0,0,
209.02,2025,Multifamily,8,7,1,0.125
209.02,2025,Single Family - Detached,1172,1014,158,0.13481228668942
209.02,2030,Mobile Home,0,0,0,
209.02,2030,Multifamily,8,6,2,0.25
209.02,2030,Single Family - Detached,1258,1104,154,0.12241653418124
209.02,2035,Mobile Home,0,0,0,
209.02,2035,Multifamily,8,6,2,0.25
209.02,2035,Single Family - Detached,1351,1197,154,0.113989637305699
209.02,2040,Mobile Home,0,0,0,
209.02,2040,Multifamily,8,6,2,0.25
209.02,2040,Single Family - Detached,1351,1196,155,0.114729829755736
209.02,2045,Mobile Home,0,0,0,
209.02,2045,Multifamily,8,6,2,0.25
209.02,2045,Single Family - Detached,1353,1192,161,0.118994826311899
209.02,2050,Mobile Home,0,0,0,
209.02,2050,Multifamily,8,6,2,0.25
209.02,2050,Single Family - Detached,1356,1193,163,0.120206489675516
209.03,2012,Mobile Home,414,287,127,0.306763285024155
209.03,2012,Multifamily,1,2,-1,-1
209.03,2012,Single Family - Detached,1215,1111,104,0.08559670781893
209.03,2020,Mobile Home,414,289,125,0.301932367149758
209.03,2020,Multifamily,1,1,0,0
209.03,2020,Single Family - Detached,1310,1171,139,0.106106870229008
209.03,2025,Mobile Home,414,288,126,0.304347826086957
209.03,2025,Multifamily,1,1,0,0
209.03,2025,Single Family - Detached,1338,1229,109,0.0814648729446936
209.03,2030,Mobile Home,414,286,128,0.309178743961353
209.03,2030,Multifamily,1,1,0,0
209.03,2030,Single Family - Detached,1419,1294,125,0.0880902043692741
209.03,2035,Mobile Home,414,287,127,0.306763285024155
209.03,2035,Multifamily,1,1,0,0
209.03,2035,Single Family - Detached,1571,1433,138,0.0878421387651178
209.03,2040,Mobile Home,414,287,127,0.306763285024155
209.03,2040,Multifamily,1,1,0,0
209.03,2040,Single Family - Detached,1571,1430,141,0.0897517504774029
209.03,2045,Mobile Home,414,285,129,0.311594202898551
209.03,2045,Multifamily,1,1,0,0
209.03,2045,Single Family - Detached,1574,1431,143,0.090851334180432
209.03,2050,Mobile Home,414,279,135,0.326086956521739
209.03,2050,Multifamily,1,1,0,0
209.03,2050,Single Family - Detached,1582,1441,141,0.0891276864728192
209.04,2012,Mobile Home,19,19,0,0
209.04,2012,Multifamily,42,34,8,0.19047619047619
209.04,2012,Single Family - Detached,1765,1395,370,0.209631728045326
209.04,2020,Mobile Home,19,19,0,0
209.04,2020,Multifamily,42,38,4,0.0952380952380952
209.04,2020,Single Family - Detached,1995,1584,411,0.206015037593985
209.04,2025,Mobile Home,19,18,1,0.0526315789473684
209.04,2025,Multifamily,42,39,3,0.0714285714285714
209.04,2025,Single Family - Detached,1998,1651,347,0.173673673673674
209.04,2030,Mobile Home,19,18,1,0.0526315789473684
209.04,2030,Multifamily,42,39,3,0.0714285714285714
209.04,2030,Single Family - Detached,2068,1708,360,0.174081237911025
209.04,2035,Mobile Home,19,19,0,0
209.04,2035,Multifamily,42,40,2,0.0476190476190476
209.04,2035,Single Family - Detached,2136,1795,341,0.159644194756554
209.04,2040,Mobile Home,19,19,0,0
209.04,2040,Multifamily,42,40,2,0.0476190476190476
209.04,2040,Single Family - Detached,2135,1792,343,0.160655737704918
209.04,2045,Mobile Home,19,18,1,0.0526315789473684
209.04,2045,Multifamily,42,40,2,0.0476190476190476
209.04,2045,Single Family - Detached,2136,1766,370,0.173220973782772
209.04,2050,Mobile Home,19,18,1,0.0526315789473684
209.04,2050,Multifamily,42,40,2,0.0476190476190476
209.04,2050,Single Family - Detached,2135,1754,381,0.178454332552693
21,2012,Mobile Home,0,0,0,
21,2012,Multifamily,1314,1234,80,0.060882800608828
21,2012,Single Family - Detached,1238,1177,61,0.0492730210016155
21,2020,Mobile Home,0,0,0,
21,2020,Multifamily,1570,1477,93,0.0592356687898089
21,2020,Single Family - Detached,1219,1167,52,0.0426579163248564
21,2025,Mobile Home,0,0,0,
21,2025,Multifamily,1728,1633,95,0.0549768518518519
21,2025,Single Family - Detached,1212,1173,39,0.0321782178217822
21,2030,Mobile Home,0,0,0,
21,2030,Multifamily,2126,2008,118,0.0555032925682032
21,2030,Single Family - Detached,1196,1156,40,0.0334448160535117
21,2035,Mobile Home,0,0,0,
21,2035,Multifamily,2127,1983,144,0.0677009873060649
21,2035,Single Family - Detached,1196,1155,41,0.0342809364548495
21,2040,Mobile Home,0,0,0,
21,2040,Multifamily,2456,2306,150,0.0610749185667752
21,2040,Single Family - Detached,1074,1036,38,0.0353817504655493
21,2045,Mobile Home,0,0,0,
21,2045,Multifamily,2607,2450,157,0.0602224779439969
21,2045,Single Family - Detached,1092,1052,40,0.0366300366300366
21,2050,Mobile Home,0,0,0,
21,2050,Multifamily,2607,2450,157,0.0602224779439969
21,2050,Single Family - Detached,1095,1055,40,0.0365296803652968
210,2012,Mobile Home,807,512,295,0.365551425030979
210,2012,Multifamily,324,285,39,0.12037037037037
210,2012,Single Family - Detached,2494,1494,1000,0.400962309542903
210,2020,Mobile Home,807,515,292,0.36183395291202
210,2020,Multifamily,324,295,29,0.0895061728395062
210,2020,Single Family - Detached,2653,1553,1100,0.414624952883528
210,2025,Mobile Home,807,514,293,0.363073110285006
210,2025,Multifamily,324,296,28,0.0864197530864197
210,2025,Single Family - Detached,2720,1771,949,0.348897058823529
210,2030,Mobile Home,807,511,296,0.366790582403965
210,2030,Multifamily,381,328,53,0.139107611548556
210,2030,Single Family - Detached,2822,1815,1007,0.356839121190645
210,2035,Mobile Home,807,512,295,0.365551425030979
210,2035,Multifamily,381,330,51,0.133858267716535
210,2035,Single Family - Detached,2988,1979,1009,0.33768406961178
210,2040,Mobile Home,807,513,294,0.364312267657993
210,2040,Multifamily,381,330,51,0.133858267716535
210,2040,Single Family - Detached,3085,2007,1078,0.349432739059968
210,2045,Mobile Home,807,511,296,0.366790582403965
210,2045,Multifamily,381,330,51,0.133858267716535
210,2045,Single Family - Detached,3184,1992,1192,0.374371859296482
210,2050,Mobile Home,807,501,306,0.379182156133829
210,2050,Multifamily,381,329,52,0.136482939632546
210,2050,Single Family - Detached,3987,2477,1510,0.378730875344871
211,2012,Mobile Home,262,258,4,0.0152671755725191
211,2012,Multifamily,121,111,10,0.0826446280991736
211,2012,Single Family - Detached,2670,2499,171,0.0640449438202247
211,2020,Mobile Home,262,260,2,0.00763358778625954
211,2020,Multifamily,121,123,-2,-0.0165289256198347
211,2020,Single Family - Detached,2846,2638,208,0.073085031623331
211,2025,Mobile Home,262,258,4,0.0152671755725191
211,2025,Multifamily,121,123,-2,-0.0165289256198347
211,2025,Single Family - Detached,2979,2805,174,0.0584088620342397
211,2030,Mobile Home,262,257,5,0.0190839694656489
211,2030,Multifamily,121,123,-2,-0.0165289256198347
211,2030,Single Family - Detached,3409,3181,228,0.0668817835142271
211,2035,Mobile Home,262,259,3,0.0114503816793893
211,2035,Multifamily,121,123,-2,-0.0165289256198347
211,2035,Single Family - Detached,3511,3293,218,0.0620905724864711
211,2040,Mobile Home,262,259,3,0.0114503816793893
211,2040,Multifamily,121,123,-2,-0.0165289256198347
211,2040,Single Family - Detached,3608,3367,241,0.0667960088691796
211,2045,Mobile Home,262,258,4,0.0152671755725191
211,2045,Multifamily,121,123,-2,-0.0165289256198347
211,2045,Single Family - Detached,3704,3428,276,0.0745140388768898
211,2050,Mobile Home,262,252,10,0.0381679389312977
211,2050,Multifamily,121,122,-1,-0.00826446280991736
211,2050,Single Family - Detached,4058,3763,295,0.0726959093149335
212.02,2012,Mobile Home,201,201,0,0
212.02,2012,Multifamily,20,17,3,0.15
212.02,2012,Single Family - Detached,999,1024,-25,-0.025025025025025
212.02,2020,Mobile Home,201,201,0,0
212.02,2020,Multifamily,20,19,1,0.05
212.02,2020,Single Family - Detached,1025,1003,22,0.0214634146341463
212.02,2025,Mobile Home,201,201,0,0
212.02,2025,Multifamily,20,19,1,0.05
212.02,2025,Single Family - Detached,1032,1022,10,0.00968992248062015
212.02,2030,Mobile Home,201,200,1,0.00497512437810945
212.02,2030,Multifamily,20,19,1,0.05
212.02,2030,Single Family - Detached,1045,1020,25,0.0239234449760766
212.02,2035,Mobile Home,201,200,1,0.00497512437810945
212.02,2035,Multifamily,20,20,0,0
212.02,2035,Single Family - Detached,1102,1073,29,0.0263157894736842
212.02,2040,Mobile Home,201,200,1,0.00497512437810945
212.02,2040,Multifamily,20,19,1,0.05
212.02,2040,Single Family - Detached,1102,1068,34,0.0308529945553539
212.02,2045,Mobile Home,201,199,2,0.00995024875621891
212.02,2045,Multifamily,20,19,1,0.05
212.02,2045,Single Family - Detached,1105,1063,42,0.0380090497737557
212.02,2050,Mobile Home,201,195,6,0.0298507462686567
212.02,2050,Multifamily,20,18,2,0.1
212.02,2050,Single Family - Detached,1107,1062,45,0.040650406504065
212.04,2012,Mobile Home,100,80,20,0.2
212.04,2012,Multifamily,0,0,0,
212.04,2012,Single Family - Detached,1804,1762,42,0.0232815964523282
212.04,2020,Mobile Home,100,80,20,0.2
212.04,2020,Multifamily,0,0,0,
212.04,2020,Single Family - Detached,1863,1569,294,0.15780998389694
212.04,2025,Mobile Home,100,80,20,0.2
212.04,2025,Multifamily,0,0,0,
212.04,2025,Single Family - Detached,1881,1617,264,0.140350877192982
212.04,2030,Mobile Home,100,80,20,0.2
212.04,2030,Multifamily,0,0,0,
212.04,2030,Single Family - Detached,1910,1603,307,0.160732984293194
212.04,2035,Mobile Home,100,80,20,0.2
212.04,2035,Multifamily,0,0,0,
212.04,2035,Single Family - Detached,1924,1588,336,0.174636174636175
212.04,2040,Mobile Home,100,80,20,0.2
212.04,2040,Multifamily,0,0,0,
212.04,2040,Single Family - Detached,1936,1578,358,0.184917355371901
212.04,2045,Mobile Home,100,80,20,0.2
212.04,2045,Multifamily,0,0,0,
212.04,2045,Single Family - Detached,1947,1551,396,0.203389830508475
212.04,2050,Mobile Home,100,78,22,0.22
212.04,2050,Multifamily,0,0,0,
212.04,2050,Single Family - Detached,2026,1642,384,0.189536031589339
212.05,2012,Mobile Home,154,154,0,0
212.05,2012,Multifamily,747,1271,-524,-0.701472556894244
212.05,2012,Single Family - Detached,1811,1194,617,0.340695748205411
212.05,2020,Mobile Home,154,154,0,0
212.05,2020,Multifamily,742,747,-5,-0.00673854447439353
212.05,2020,Single Family - Detached,2404,2152,252,0.104825291181364
212.05,2025,Mobile Home,154,154,0,0
212.05,2025,Multifamily,714,719,-5,-0.00700280112044818
212.05,2025,Single Family - Detached,2664,2482,182,0.0683183183183183
212.05,2030,Mobile Home,154,153,1,0.00649350649350649
212.05,2030,Multifamily,680,685,-5,-0.00735294117647059
212.05,2030,Single Family - Detached,2922,2712,210,0.0718685831622177
212.05,2035,Mobile Home,154,153,1,0.00649350649350649
212.05,2035,Multifamily,638,640,-2,-0.00313479623824451
212.05,2035,Single Family - Detached,3246,3061,185,0.0569932224276032
212.05,2040,Mobile Home,154,154,0,0
212.05,2040,Multifamily,666,669,-3,-0.0045045045045045
212.05,2040,Single Family - Detached,3324,3129,195,0.0586642599277978
212.05,2045,Mobile Home,154,153,1,0.00649350649350649
212.05,2045,Multifamily,836,840,-4,-0.00478468899521531
212.05,2045,Single Family - Detached,3424,3216,208,0.0607476635514019
212.05,2050,Mobile Home,148,147,1,0.00675675675675676
212.05,2050,Multifamily,995,998,-3,-0.00301507537688442
212.05,2050,Single Family - Detached,3477,3244,233,0.0670117917745183
212.06,2012,Mobile Home,0,0,0,
212.06,2012,Multifamily,1,0,1,1
212.06,2012,Single Family - Detached,1129,1118,11,0.00974313551815766
212.06,2020,Mobile Home,0,0,0,
212.06,2020,Multifamily,5,0,5,1
212.06,2020,Single Family - Detached,1129,952,177,0.156775907883082
212.06,2025,Mobile Home,0,0,0,
212.06,2025,Multifamily,5,0,5,1
212.06,2025,Single Family - Detached,1339,1140,199,0.148618371919343
212.06,2030,Mobile Home,0,0,0,
212.06,2030,Multifamily,5,0,5,1
212.06,2030,Single Family - Detached,1502,1326,176,0.117177097203728
212.06,2035,Mobile Home,0,0,0,
212.06,2035,Multifamily,8,6,2,0.25
212.06,2035,Single Family - Detached,1555,1409,146,0.0938906752411576
212.06,2040,Mobile Home,0,0,0,
212.06,2040,Multifamily,44,39,5,0.113636363636364
212.06,2040,Single Family - Detached,1578,1413,165,0.104562737642586
212.06,2045,Mobile Home,0,0,0,
212.06,2045,Multifamily,98,91,7,0.0714285714285714
212.06,2045,Single Family - Detached,1609,1416,193,0.119950279676818
212.06,2050,Mobile Home,0,0,0,
212.06,2050,Multifamily,143,135,8,0.0559440559440559
212.06,2050,Single Family - Detached,1632,1425,207,0.126838235294118
213.02,2012,Mobile Home,41,41,0,0
213.02,2012,Multifamily,124,125,-1,-0.00806451612903226
213.02,2012,Single Family - Detached,1339,1338,1,0.000746825989544436
213.02,2020,Mobile Home,41,41,0,0
213.02,2020,Multifamily,124,124,0,0
213.02,2020,Single Family - Detached,1601,1599,2,0.00124921923797626
213.02,2025,Mobile Home,41,41,0,0
213.02,2025,Multifamily,124,124,0,0
213.02,2025,Single Family - Detached,1602,1602,0,0
213.02,2030,Mobile Home,41,41,0,0
213.02,2030,Multifamily,124,123,1,0.00806451612903226
213.02,2030,Single Family - Detached,1637,1637,0,0
213.02,2035,Mobile Home,41,41,0,0
213.02,2035,Multifamily,124,124,0,0
213.02,2035,Single Family - Detached,1649,1649,0,0
213.02,2040,Mobile Home,41,41,0,0
213.02,2040,Multifamily,124,123,1,0.00806451612903226
213.02,2040,Single Family - Detached,1773,1771,2,0.00112803158488438
213.02,2045,Mobile Home,41,41,0,0
213.02,2045,Multifamily,124,122,2,0.0161290322580645
213.02,2045,Single Family - Detached,1904,1901,3,0.00157563025210084
213.02,2050,Mobile Home,41,40,1,0.024390243902439
213.02,2050,Multifamily,124,122,2,0.0161290322580645
213.02,2050,Single Family - Detached,1906,1903,3,0.00157397691500525
213.03,2012,Mobile Home,18,18,0,0
213.03,2012,Multifamily,98,96,2,0.0204081632653061
213.03,2012,Single Family - Detached,2695,2646,49,0.0181818181818182
213.03,2020,Mobile Home,18,18,0,0
213.03,2020,Multifamily,98,97,1,0.0102040816326531
213.03,2020,Single Family - Detached,3129,3062,67,0.0214125918823905
213.03,2025,Mobile Home,18,17,1,0.0555555555555556
213.03,2025,Multifamily,98,97,1,0.0102040816326531
213.03,2025,Single Family - Detached,3128,3074,54,0.0172634271099744
213.03,2030,Mobile Home,18,18,0,0
213.03,2030,Multifamily,98,96,2,0.0204081632653061
213.03,2030,Single Family - Detached,3163,3105,58,0.0183370218147328
213.03,2035,Mobile Home,18,18,0,0
213.03,2035,Multifamily,98,97,1,0.0102040816326531
213.03,2035,Single Family - Detached,3163,3112,51,0.0161239329750237
213.03,2040,Mobile Home,13,13,0,0
213.03,2040,Multifamily,98,97,1,0.0102040816326531
213.03,2040,Single Family - Detached,3174,3113,61,0.0192186515437933
213.03,2045,Mobile Home,8,7,1,0.125
213.03,2045,Multifamily,98,96,2,0.0204081632653061
213.03,2045,Single Family - Detached,3268,3198,70,0.0214198286413709
213.03,2050,Mobile Home,2,1,1,0.5
213.03,2050,Multifamily,98,96,2,0.0204081632653061
213.03,2050,Single Family - Detached,3270,3198,72,0.0220183486238532
213.04,2012,Mobile Home,0,0,0,
213.04,2012,Multifamily,1,2,-1,-1
213.04,2012,Single Family - Detached,865,829,36,0.0416184971098266
213.04,2020,Mobile Home,0,0,0,
213.04,2020,Multifamily,1,2,-1,-1
213.04,2020,Single Family - Detached,1105,1055,50,0.0452488687782805
213.04,2025,Mobile Home,0,0,0,
213.04,2025,Multifamily,1,2,-1,-1
213.04,2025,Single Family - Detached,1362,1312,50,0.0367107195301028
213.04,2030,Mobile Home,0,0,0,
213.04,2030,Multifamily,1,2,-1,-1
213.04,2030,Single Family - Detached,1598,1543,55,0.0344180225281602
213.04,2035,Mobile Home,0,0,0,
213.04,2035,Multifamily,1,2,-1,-1
213.04,2035,Single Family - Detached,1767,1711,56,0.0316921335597057
213.04,2040,Mobile Home,0,0,0,
213.04,2040,Multifamily,1,2,-1,-1
213.04,2040,Single Family - Detached,1943,1880,63,0.0324240864642306
213.04,2045,Mobile Home,0,0,0,
213.04,2045,Multifamily,1,2,-1,-1
213.04,2045,Single Family - Detached,2084,2012,72,0.0345489443378119
213.04,2050,Mobile Home,0,0,0,
213.04,2050,Multifamily,1,1,0,0
213.04,2050,Single Family - Detached,2119,2045,74,0.0349221330816423
214,2012,Mobile Home,0,0,0,
214,2012,Multifamily,950,922,28,0.0294736842105263
214,2012,Single Family - Detached,1980,1899,81,0.0409090909090909
214,2020,Mobile Home,0,0,0,
214,2020,Multifamily,996,967,29,0.0291164658634538
214,2020,Single Family - Detached,1979,1873,106,0.0535624052551794
214,2025,Mobile Home,0,0,0,
214,2025,Multifamily,1435,1401,34,0.0236933797909408
214,2025,Single Family - Detached,1894,1798,96,0.0506863780359029
214,2030,Mobile Home,0,0,0,
214,2030,Multifamily,1740,1691,49,0.0281609195402299
214,2030,Single Family - Detached,1846,1749,97,0.052546045503792
214,2035,Mobile Home,0,0,0,
214,2035,Multifamily,2279,2213,66,0.0289600702062308
214,2035,Single Family - Detached,1742,1645,97,0.055683122847302
214,2040,Mobile Home,0,0,0,
214,2040,Multifamily,2547,2440,107,0.0420102080879466
214,2040,Single Family - Detached,1700,1588,112,0.0658823529411765
214,2045,Mobile Home,0,0,0,
214,2045,Multifamily,2547,2426,121,0.0475068708284256
214,2045,Single Family - Detached,1701,1572,129,0.0758377425044092
214,2050,Mobile Home,0,0,0,
214,2050,Multifamily,2548,2424,124,0.0486656200941915
214,2050,Single Family - Detached,1701,1559,142,0.0834803057025279
215,2012,Mobile Home,0,0,0,
215,2012,Multifamily,392,389,3,0.0076530612244898
215,2012,Single Family - Detached,2360,2320,40,0.0169491525423729
215,2020,Mobile Home,0,0,0,
215,2020,Multifamily,892,887,5,0.00560538116591928
215,2020,Single Family - Detached,4096,4047,49,0.011962890625
215,2025,Mobile Home,0,0,0,
215,2025,Multifamily,892,892,0,0
215,2025,Single Family - Detached,4099,4063,36,0.00878262990973408
215,2030,Mobile Home,0,0,0,
215,2030,Multifamily,892,892,0,0
215,2030,Single Family - Detached,4103,4067,36,0.008774067755301
215,2035,Mobile Home,0,0,0,
215,2035,Multifamily,892,892,0,0
215,2035,Single Family - Detached,4107,4076,31,0.00754808862916971
215,2040,Mobile Home,0,0,0,
215,2040,Multifamily,892,890,2,0.00224215246636771
215,2040,Single Family - Detached,4107,4072,35,0.00852203554906258
215,2045,Mobile Home,0,0,0,
215,2045,Multifamily,892,890,2,0.00224215246636771
215,2045,Single Family - Detached,4107,4069,38,0.00925249573898223
215,2050,Mobile Home,0,0,0,
215,2050,Multifamily,892,890,2,0.00224215246636771
215,2050,Single Family - Detached,4107,4069,38,0.00925249573898223
216,2012,Mobile Home,0,0,0,
216,2012,Multifamily,1469,634,835,0.568413886997958
216,2012,Single Family - Detached,433,309,124,0.286374133949192
216,2020,Mobile Home,0,0,0,
216,2020,Multifamily,1469,640,829,0.564329475833901
216,2020,Single Family - Detached,433,309,124,0.286374133949192
216,2025,Mobile Home,0,0,0,
216,2025,Multifamily,1469,642,827,0.562968005445882
216,2025,Single Family - Detached,433,309,124,0.286374133949192
216,2030,Mobile Home,0,0,0,
216,2030,Multifamily,1469,642,827,0.562968005445882
216,2030,Single Family - Detached,433,309,124,0.286374133949192
216,2035,Mobile Home,0,0,0,
216,2035,Multifamily,1469,643,826,0.562287270251872
216,2035,Single Family - Detached,433,309,124,0.286374133949192
216,2040,Mobile Home,0,0,0,
216,2040,Multifamily,1469,642,827,0.562968005445882
216,2040,Single Family - Detached,433,309,124,0.286374133949192
216,2045,Mobile Home,0,0,0,
216,2045,Multifamily,1469,642,827,0.562968005445882
216,2045,Single Family - Detached,433,309,124,0.286374133949192
216,2050,Mobile Home,0,0,0,
216,2050,Multifamily,1469,642,827,0.562968005445882
216,2050,Single Family - Detached,433,310,123,0.284064665127021
218,2012,Mobile Home,0,0,0,
218,2012,Multifamily,273,216,57,0.208791208791209
218,2012,Single Family - Detached,765,661,104,0.135947712418301
218,2020,Mobile Home,0,0,0,
218,2020,Multifamily,287,220,67,0.233449477351916
218,2020,Single Family - Detached,769,653,116,0.150845253576073
218,2025,Mobile Home,0,0,0,
218,2025,Multifamily,287,227,60,0.209059233449477
218,2025,Single Family - Detached,769,667,102,0.132639791937581
218,2030,Mobile Home,0,0,0,
218,2030,Multifamily,287,225,62,0.21602787456446
218,2030,Single Family - Detached,769,667,102,0.132639791937581
218,2035,Mobile Home,0,0,0,
218,2035,Multifamily,284,227,57,0.200704225352113
218,2035,Single Family - Detached,769,671,98,0.127438231469441
218,2040,Mobile Home,0,0,0,
218,2040,Multifamily,281,221,60,0.213523131672598
218,2040,Single Family - Detached,769,677,92,0.11963589076723
218,2045,Mobile Home,0,0,0,
218,2045,Multifamily,279,202,77,0.275985663082437
218,2045,Single Family - Detached,769,665,104,0.135240572171652
218,2050,Mobile Home,0,0,0,
218,2050,Multifamily,280,208,72,0.257142857142857
218,2050,Single Family - Detached,769,664,105,0.136540962288687
219,2012,Mobile Home,0,0,0,
219,2012,Multifamily,369,193,176,0.476964769647696
219,2012,Single Family - Detached,395,328,67,0.169620253164557
219,2020,Mobile Home,0,0,0,
219,2020,Multifamily,360,200,160,0.444444444444444
219,2020,Single Family - Detached,423,356,67,0.15839243498818
219,2025,Mobile Home,0,0,0,
219,2025,Multifamily,360,206,154,0.427777777777778
219,2025,Single Family - Detached,423,373,50,0.118203309692671
219,2030,Mobile Home,0,0,0,
219,2030,Multifamily,431,268,163,0.378190255220418
219,2030,Single Family - Detached,423,373,50,0.118203309692671
219,2035,Mobile Home,0,0,0,
219,2035,Multifamily,1050,864,186,0.177142857142857
219,2035,Single Family - Detached,406,363,43,0.105911330049261
219,2040,Mobile Home,0,0,0,
219,2040,Multifamily,1386,1173,213,0.153679653679654
219,2040,Single Family - Detached,261,232,29,0.111111111111111
219,2045,Mobile Home,0,0,0,
219,2045,Multifamily,1668,1423,245,0.146882494004796
219,2045,Single Family - Detached,204,186,18,0.0882352941176471
219,2050,Mobile Home,0,0,0,
219,2050,Multifamily,1697,1450,247,0.145550972304066
219,2050,Single Family - Detached,207,191,16,0.0772946859903382
220,2012,Mobile Home,0,0,0,
220,2012,Multifamily,730,695,35,0.0479452054794521
220,2012,Single Family - Detached,464,451,13,0.0280172413793103
220,2020,Mobile Home,0,0,0,
220,2020,Multifamily,681,652,29,0.0425844346549192
220,2020,Single Family - Detached,436,413,23,0.0527522935779817
220,2025,Mobile Home,0,0,0,
220,2025,Multifamily,699,679,20,0.0286123032904149
220,2025,Single Family - Detached,436,419,17,0.0389908256880734
220,2030,Mobile Home,0,0,0,
220,2030,Multifamily,1061,1035,26,0.0245051837888784
220,2030,Single Family - Detached,350,331,19,0.0542857142857143
220,2035,Mobile Home,0,0,0,
220,2035,Multifamily,1667,1633,34,0.0203959208158368
220,2035,Single Family - Detached,320,307,13,0.040625
220,2040,Mobile Home,0,0,0,
220,2040,Multifamily,1740,1707,33,0.0189655172413793
220,2040,Single Family - Detached,315,299,16,0.0507936507936508
220,2045,Mobile Home,0,0,0,
220,2045,Multifamily,1758,1708,50,0.0284414106939704
220,2045,Single Family - Detached,312,297,15,0.0480769230769231
220,2050,Mobile Home,0,0,0,
220,2050,Multifamily,2214,2133,81,0.0365853658536585
220,2050,Single Family - Detached,312,295,17,0.0544871794871795
22.01,2012,Mobile Home,0,0,0,
22.01,2012,Multifamily,886,858,28,0.0316027088036117
22.01,2012,Single Family - Detached,393,369,24,0.0610687022900763
22.01,2020,Mobile Home,0,0,0,
22.01,2020,Multifamily,884,864,20,0.0226244343891403
22.01,2020,Single Family - Detached,375,354,21,0.056
22.01,2025,Mobile Home,0,0,0,
22.01,2025,Multifamily,887,869,18,0.020293122886133
22.01,2025,Single Family - Detached,375,357,18,0.048
22.01,2030,Mobile Home,0,0,0,
22.01,2030,Multifamily,1437,1413,24,0.0167014613778706
22.01,2030,Single Family - Detached,257,249,8,0.0311284046692607
22.01,2035,Mobile Home,0,0,0,
22.01,2035,Multifamily,1697,1678,19,0.0111962286387743
22.01,2035,Single Family - Detached,147,147,0,0
22.01,2040,Mobile Home,0,0,0,
22.01,2040,Multifamily,1697,1676,21,0.0123747790218032
22.01,2040,Single Family - Detached,147,145,2,0.0136054421768707
22.01,2045,Mobile Home,0,0,0,
22.01,2045,Multifamily,1697,1669,28,0.0164997053624042
22.01,2045,Single Family - Detached,147,141,6,0.0408163265306122
22.01,2050,Mobile Home,0,0,0,
22.01,2050,Multifamily,1697,1657,40,0.0235710076605775
22.01,2050,Single Family - Detached,147,137,10,0.0680272108843537
22.02,2012,Mobile Home,0,0,0,
22.02,2012,Multifamily,1421,1357,64,0.0450387051372273
22.02,2012,Single Family - Detached,404,393,11,0.0272277227722772
22.02,2020,Mobile Home,0,0,0,
22.02,2020,Multifamily,1416,1350,66,0.0466101694915254
22.02,2020,Single Family - Detached,395,368,27,0.0683544303797468
22.02,2025,Mobile Home,0,0,0,
22.02,2025,Multifamily,1501,1464,37,0.0246502331778814
22.02,2025,Single Family - Detached,389,370,19,0.0488431876606684
22.02,2030,Mobile Home,0,0,0,
22.02,2030,Multifamily,1880,1840,40,0.0212765957446809
22.02,2030,Single Family - Detached,261,248,13,0.0498084291187739
22.02,2035,Mobile Home,0,0,0,
22.02,2035,Multifamily,2464,2427,37,0.0150162337662338
22.02,2035,Single Family - Detached,138,137,1,0.0072463768115942
22.02,2040,Mobile Home,0,0,0,
22.02,2040,Multifamily,2560,2514,46,0.01796875
22.02,2040,Single Family - Detached,128,121,7,0.0546875
22.02,2045,Mobile Home,0,0,0,
22.02,2045,Multifamily,2560,2499,61,0.023828125
22.02,2045,Single Family - Detached,128,111,17,0.1328125
22.02,2050,Mobile Home,0,0,0,
22.02,2050,Multifamily,2560,2476,84,0.0328125
22.02,2050,Single Family - Detached,128,102,26,0.203125
221,2012,Mobile Home,111,84,27,0.243243243243243
221,2012,Multifamily,997,984,13,0.0130391173520562
221,2012,Single Family - Detached,2470,2345,125,0.0506072874493927
221,2020,Mobile Home,112,98,14,0.125
221,2020,Multifamily,1011,998,13,0.0128585558852621
221,2020,Single Family - Detached,2730,2565,165,0.0604395604395604
221,2025,Mobile Home,112,98,14,0.125
221,2025,Multifamily,1011,999,12,0.0118694362017804
221,2025,Single Family - Detached,2788,2654,134,0.0480631276901004
221,2030,Mobile Home,112,98,14,0.125
221,2030,Multifamily,1011,999,12,0.0118694362017804
221,2030,Single Family - Detached,2848,2704,144,0.050561797752809
221,2035,Mobile Home,112,98,14,0.125
221,2035,Multifamily,1011,999,12,0.0118694362017804
221,2035,Single Family - Detached,2851,2722,129,0.0452472816555595
221,2040,Mobile Home,112,98,14,0.125
221,2040,Multifamily,1011,996,15,0.0148367952522255
221,2040,Single Family - Detached,2851,2716,135,0.047351806383725
221,2045,Mobile Home,112,98,14,0.125
221,2045,Multifamily,1011,995,16,0.0158259149357072
221,2045,Single Family - Detached,2851,2712,139,0.0487548228691687
221,2050,Mobile Home,112,97,15,0.133928571428571
221,2050,Multifamily,1011,994,17,0.0168150346191889
221,2050,Single Family - Detached,2851,2712,139,0.0487548228691687
23.01,2012,Mobile Home,0,0,0,
23.01,2012,Multifamily,905,863,42,0.0464088397790055
23.01,2012,Single Family - Detached,311,297,14,0.045016077170418
23.01,2020,Mobile Home,0,0,0,
23.01,2020,Multifamily,907,865,42,0.0463065049614112
23.01,2020,Single Family - Detached,311,289,22,0.0707395498392283
23.01,2025,Mobile Home,0,0,0,
23.01,2025,Multifamily,908,869,39,0.0429515418502203
23.01,2025,Single Family - Detached,311,298,13,0.0418006430868167
23.01,2030,Mobile Home,0,0,0,
23.01,2030,Multifamily,1306,1262,44,0.0336906584992343
23.01,2030,Single Family - Detached,291,282,9,0.0309278350515464
23.01,2035,Mobile Home,0,0,0,
23.01,2035,Multifamily,1604,1561,43,0.0268079800498753
23.01,2035,Single Family - Detached,278,274,4,0.0143884892086331
23.01,2040,Mobile Home,0,0,0,
23.01,2040,Multifamily,1604,1556,48,0.029925187032419
23.01,2040,Single Family - Detached,278,271,7,0.0251798561151079
23.01,2045,Mobile Home,0,0,0,
23.01,2045,Multifamily,1604,1556,48,0.029925187032419
23.01,2045,Single Family - Detached,278,269,9,0.0323741007194245
23.01,2050,Mobile Home,0,0,0,
23.01,2050,Multifamily,1604,1556,48,0.029925187032419
23.01,2050,Single Family - Detached,278,269,9,0.0323741007194245
23.02,2012,Mobile Home,0,0,0,
23.02,2012,Multifamily,1539,1485,54,0.0350877192982456
23.02,2012,Single Family - Detached,640,615,25,0.0390625
23.02,2020,Mobile Home,0,0,0,
23.02,2020,Multifamily,1574,1525,49,0.031130876747141
23.02,2020,Single Family - Detached,618,594,24,0.0388349514563107
23.02,2025,Mobile Home,0,0,0,
23.02,2025,Multifamily,1574,1527,47,0.0298602287166455
23.02,2025,Single Family - Detached,618,599,19,0.0307443365695793
23.02,2030,Mobile Home,0,0,0,
23.02,2030,Multifamily,1569,1524,45,0.0286806883365201
23.02,2030,Single Family - Detached,616,597,19,0.0308441558441558
23.02,2035,Mobile Home,0,0,0,
23.02,2035,Multifamily,1842,1798,44,0.0238870792616721
23.02,2035,Single Family - Detached,553,540,13,0.0235081374321881
23.02,2040,Mobile Home,0,0,0,
23.02,2040,Multifamily,2203,2150,53,0.0240581025873808
23.02,2040,Single Family - Detached,442,430,12,0.0271493212669683
23.02,2045,Mobile Home,0,0,0,
23.02,2045,Multifamily,2684,2642,42,0.0156482861400894
23.02,2045,Single Family - Detached,225,215,10,0.0444444444444444
23.02,2050,Mobile Home,0,0,0,
23.02,2050,Multifamily,2898,2829,69,0.0238095238095238
23.02,2050,Single Family - Detached,177,162,15,0.0847457627118644
24.01,2012,Mobile Home,0,0,0,
24.01,2012,Multifamily,912,892,20,0.0219298245614035
24.01,2012,Single Family - Detached,778,716,62,0.0796915167095116
24.01,2020,Mobile Home,0,0,0,
24.01,2020,Multifamily,912,887,25,0.0274122807017544
24.01,2020,Single Family - Detached,845,800,45,0.0532544378698225
24.01,2025,Mobile Home,0,0,0,
24.01,2025,Multifamily,910,888,22,0.0241758241758242
24.01,2025,Single Family - Detached,831,794,37,0.0445246690734055
24.01,2030,Mobile Home,0,0,0,
24.01,2030,Multifamily,920,905,15,0.016304347826087
24.01,2030,Single Family - Detached,826,793,33,0.0399515738498789
24.01,2035,Mobile Home,0,0,0,
24.01,2035,Multifamily,1273,1259,14,0.0109976433621367
24.01,2035,Single Family - Detached,719,686,33,0.0458970792767733
24.01,2040,Mobile Home,0,0,0,
24.01,2040,Multifamily,1425,1408,17,0.0119298245614035
24.01,2040,Single Family - Detached,670,639,31,0.0462686567164179
24.01,2045,Mobile Home,0,0,0,
24.01,2045,Multifamily,1425,1398,27,0.0189473684210526
24.01,2045,Single Family - Detached,670,633,37,0.0552238805970149
24.01,2050,Mobile Home,0,0,0,
24.01,2050,Multifamily,1425,1385,40,0.0280701754385965
24.01,2050,Single Family - Detached,670,627,43,0.0641791044776119
24.02,2012,Mobile Home,0,0,0,
24.02,2012,Multifamily,992,966,26,0.0262096774193548
24.02,2012,Single Family - Detached,554,525,29,0.0523465703971119
24.02,2020,Mobile Home,0,0,0,
24.02,2020,Multifamily,992,960,32,0.032258064516129
24.02,2020,Single Family - Detached,598,576,22,0.0367892976588629
24.02,2025,Mobile Home,0,0,0,
24.02,2025,Multifamily,992,961,31,0.03125
24.02,2025,Single Family - Detached,598,582,16,0.0267558528428094
24.02,2030,Mobile Home,0,0,0,
24.02,2030,Multifamily,992,959,33,0.0332661290322581
24.02,2030,Single Family - Detached,598,581,17,0.0284280936454849
24.02,2035,Mobile Home,0,0,0,
24.02,2035,Multifamily,998,972,26,0.0260521042084168
24.02,2035,Single Family - Detached,587,572,15,0.0255536626916525
24.02,2040,Mobile Home,0,0,0,
24.02,2040,Multifamily,1145,1114,31,0.0270742358078603
24.02,2040,Single Family - Detached,534,522,12,0.0224719101123595
24.02,2045,Mobile Home,0,0,0,
24.02,2045,Multifamily,1321,1274,47,0.0355791067373202
24.02,2045,Single Family - Detached,534,520,14,0.0262172284644195
24.02,2050,Mobile Home,0,0,0,
24.02,2050,Multifamily,1321,1258,63,0.0476911430734292
24.02,2050,Single Family - Detached,534,519,15,0.0280898876404494
25.01,2012,Mobile Home,0,0,0,
25.01,2012,Multifamily,391,377,14,0.0358056265984655
25.01,2012,Single Family - Detached,1190,1139,51,0.0428571428571429
25.01,2020,Mobile Home,0,0,0,
25.01,2020,Multifamily,401,376,25,0.0623441396508728
25.01,2020,Single Family - Detached,1224,1152,72,0.0588235294117647
25.01,2025,Mobile Home,0,0,0,
25.01,2025,Multifamily,401,382,19,0.0473815461346633
25.01,2025,Single Family - Detached,1224,1161,63,0.0514705882352941
25.01,2030,Mobile Home,0,0,0,
25.01,2030,Multifamily,401,373,28,0.0698254364089776
25.01,2030,Single Family - Detached,1224,1158,66,0.053921568627451
25.01,2035,Mobile Home,0,0,0,
25.01,2035,Multifamily,401,364,37,0.0922693266832918
25.01,2035,Single Family - Detached,1224,1161,63,0.0514705882352941
25.01,2040,Mobile Home,0,0,0,
25.01,2040,Multifamily,375,345,30,0.08
25.01,2040,Single Family - Detached,1182,1129,53,0.044839255499154
25.01,2045,Mobile Home,0,0,0,
25.01,2045,Multifamily,628,582,46,0.0732484076433121
25.01,2045,Single Family - Detached,1158,1103,55,0.0474956822107081
25.01,2050,Mobile Home,0,0,0,
25.01,2050,Multifamily,628,568,60,0.0955414012738854
25.01,2050,Single Family - Detached,1158,1101,57,0.0492227979274611
25.02,2012,Mobile Home,0,0,0,
25.02,2012,Multifamily,430,427,3,0.00697674418604651
25.02,2012,Single Family - Detached,1589,1557,32,0.0201384518565135
25.02,2020,Mobile Home,0,0,0,
25.02,2020,Multifamily,430,417,13,0.0302325581395349
25.02,2020,Single Family - Detached,1592,1539,53,0.0332914572864322
25.02,2025,Mobile Home,0,0,0,
25.02,2025,Multifamily,430,423,7,0.0162790697674419
25.02,2025,Single Family - Detached,1592,1552,40,0.0251256281407035
25.02,2030,Mobile Home,0,0,0,
25.02,2030,Multifamily,430,414,16,0.0372093023255814
25.02,2030,Single Family - Detached,1592,1548,44,0.0276381909547739
25.02,2035,Mobile Home,0,0,0,
25.02,2035,Multifamily,430,406,24,0.0558139534883721
25.02,2035,Single Family - Detached,1592,1553,39,0.0244974874371859
25.02,2040,Mobile Home,0,0,0,
25.02,2040,Multifamily,446,412,34,0.0762331838565022
25.02,2040,Single Family - Detached,1592,1549,43,0.0270100502512563
25.02,2045,Mobile Home,0,0,0,
25.02,2045,Multifamily,547,508,39,0.0712979890310786
25.02,2045,Single Family - Detached,1558,1507,51,0.0327342747111682
25.02,2050,Mobile Home,0,0,0,
25.02,2050,Multifamily,766,706,60,0.0783289817232376
25.02,2050,Single Family - Detached,1467,1417,50,0.0340831629175187
26.01,2012,Mobile Home,0,0,0,
26.01,2012,Multifamily,457,434,23,0.050328227571116
26.01,2012,Single Family - Detached,1203,1167,36,0.029925187032419
26.01,2020,Mobile Home,0,0,0,
26.01,2020,Multifamily,457,423,34,0.074398249452954
26.01,2020,Single Family - Detached,1284,1248,36,0.0280373831775701
26.01,2025,Mobile Home,0,0,0,
26.01,2025,Multifamily,457,431,26,0.0568927789934354
26.01,2025,Single Family - Detached,1284,1256,28,0.0218068535825545
26.01,2030,Mobile Home,0,0,0,
26.01,2030,Multifamily,457,421,36,0.0787746170678337
26.01,2030,Single Family - Detached,1285,1256,29,0.022568093385214
26.01,2035,Mobile Home,0,0,0,
26.01,2035,Multifamily,457,411,46,0.100656455142232
26.01,2035,Single Family - Detached,1285,1258,27,0.021011673151751
26.01,2040,Mobile Home,0,0,0,
26.01,2040,Multifamily,769,706,63,0.081924577373212
26.01,2040,Single Family - Detached,1192,1162,30,0.0251677852348993
26.01,2045,Mobile Home,0,0,0,
26.01,2045,Multifamily,1229,1164,65,0.0528885272579333
26.01,2045,Single Family - Detached,1125,1104,21,0.0186666666666667
26.01,2050,Mobile Home,0,0,0,
26.01,2050,Multifamily,1229,1147,82,0.0667209113100081
26.01,2050,Single Family - Detached,1126,1105,21,0.0186500888099467
26.02,2012,Mobile Home,0,0,0,
26.02,2012,Multifamily,425,378,47,0.110588235294118
26.02,2012,Single Family - Detached,798,754,44,0.0551378446115288
26.02,2020,Mobile Home,0,0,0,
26.02,2020,Multifamily,425,367,58,0.136470588235294
26.02,2020,Single Family - Detached,818,764,54,0.0660146699266504
26.02,2025,Mobile Home,0,0,0,
26.02,2025,Multifamily,425,371,54,0.127058823529412
26.02,2025,Single Family - Detached,818,777,41,0.0501222493887531
26.02,2030,Mobile Home,0,0,0,
26.02,2030,Multifamily,425,364,61,0.143529411764706
26.02,2030,Single Family - Detached,818,776,42,0.0513447432762836
26.02,2035,Mobile Home,0,0,0,
26.02,2035,Multifamily,442,374,68,0.153846153846154
26.02,2035,Single Family - Detached,818,777,41,0.0501222493887531
26.02,2040,Mobile Home,0,0,0,
26.02,2040,Multifamily,461,388,73,0.158351409978308
26.02,2040,Single Family - Detached,818,776,42,0.0513447432762836
26.02,2045,Mobile Home,0,0,0,
26.02,2045,Multifamily,573,495,78,0.136125654450262
26.02,2045,Single Family - Detached,805,758,47,0.0583850931677019
26.02,2050,Mobile Home,0,0,0,
26.02,2050,Multifamily,573,480,93,0.162303664921466
26.02,2050,Single Family - Detached,806,760,46,0.0570719602977667
27.02,2012,Mobile Home,0,0,0,
27.02,2012,Multifamily,1217,1217,0,0
27.02,2012,Single Family - Detached,780,759,21,0.0269230769230769
27.02,2020,Mobile Home,0,0,0,
27.02,2020,Multifamily,1217,1210,7,0.0057518488085456
27.02,2020,Single Family - Detached,781,757,24,0.030729833546735
27.02,2025,Mobile Home,0,0,0,
27.02,2025,Multifamily,1212,1209,3,0.00247524752475248
27.02,2025,Single Family - Detached,785,764,21,0.0267515923566879
27.02,2030,Mobile Home,0,0,0,
27.02,2030,Multifamily,1204,1201,3,0.00249169435215947
27.02,2030,Single Family - Detached,785,760,25,0.0318471337579618
27.02,2035,Mobile Home,0,0,0,
27.02,2035,Multifamily,1211,1203,8,0.00660611065235343
27.02,2035,Single Family - Detached,785,764,21,0.0267515923566879
27.02,2040,Mobile Home,0,0,0,
27.02,2040,Multifamily,1657,1636,21,0.0126735063367532
27.02,2040,Single Family - Detached,786,761,25,0.0318066157760814
27.02,2045,Mobile Home,0,0,0,
27.02,2045,Multifamily,2149,2114,35,0.0162866449511401
27.02,2045,Single Family - Detached,781,752,29,0.0371318822023047
27.02,2050,Mobile Home,0,0,0,
27.02,2050,Multifamily,2392,2341,51,0.0213210702341137
27.02,2050,Single Family - Detached,784,753,31,0.0395408163265306
27.03,2012,Mobile Home,0,0,0,
27.03,2012,Multifamily,1158,1124,34,0.0293609671848014
27.03,2012,Single Family - Detached,1227,1216,11,0.00896495517522412
27.03,2020,Mobile Home,0,0,0,
27.03,2020,Multifamily,1451,1408,43,0.0296347346657478
27.03,2020,Single Family - Detached,1227,1215,12,0.0097799511002445
27.03,2025,Mobile Home,0,0,0,
27.03,2025,Multifamily,1451,1409,42,0.0289455547898001
27.03,2025,Single Family - Detached,1236,1226,10,0.00809061488673139
27.03,2030,Mobile Home,0,0,0,
27.03,2030,Multifamily,1451,1408,43,0.0296347346657478
27.03,2030,Single Family - Detached,1236,1223,13,0.0105177993527508
27.03,2035,Mobile Home,0,0,0,
27.03,2035,Multifamily,1451,1405,46,0.0317022742935906
27.03,2035,Single Family - Detached,1236,1226,10,0.00809061488673139
27.03,2040,Mobile Home,0,0,0,
27.03,2040,Multifamily,2163,2111,52,0.024040684234859
27.03,2040,Single Family - Detached,1239,1224,15,0.0121065375302663
27.03,2045,Mobile Home,0,0,0,
27.03,2045,Multifamily,2683,2639,44,0.0163995527394707
27.03,2045,Single Family - Detached,1239,1220,19,0.0153349475383374
27.03,2050,Mobile Home,0,0,0,
27.03,2050,Multifamily,3476,3413,63,0.0181242807825086
27.03,2050,Single Family - Detached,1230,1209,21,0.0170731707317073
27.05,2012,Mobile Home,0,0,0,
27.05,2012,Multifamily,92,92,0,0
27.05,2012,Single Family - Detached,1204,1193,11,0.00913621262458472
27.05,2020,Mobile Home,0,0,0,
27.05,2020,Multifamily,92,92,0,0
27.05,2020,Single Family - Detached,1204,1193,11,0.00913621262458472
27.05,2025,Mobile Home,0,0,0,
27.05,2025,Multifamily,92,92,0,0
27.05,2025,Single Family - Detached,1211,1202,9,0.0074318744838976
27.05,2030,Mobile Home,0,0,0,
27.05,2030,Multifamily,223,220,3,0.0134529147982063
27.05,2030,Single Family - Detached,1227,1218,9,0.00733496332518337
27.05,2035,Mobile Home,0,0,0,
27.05,2035,Multifamily,223,220,3,0.0134529147982063
27.05,2035,Single Family - Detached,1227,1218,9,0.00733496332518337
27.05,2040,Mobile Home,0,0,0,
27.05,2040,Multifamily,223,218,5,0.0224215246636771
27.05,2040,Single Family - Detached,1227,1218,9,0.00733496332518337
27.05,2045,Mobile Home,0,0,0,
27.05,2045,Multifamily,223,216,7,0.031390134529148
27.05,2045,Single Family - Detached,1227,1218,9,0.00733496332518337
27.05,2050,Mobile Home,0,0,0,
27.05,2050,Multifamily,223,214,9,0.0403587443946188
27.05,2050,Single Family - Detached,1227,1218,9,0.00733496332518337
27.07,2012,Mobile Home,0,0,0,
27.07,2012,Multifamily,1145,1103,42,0.0366812227074236
27.07,2012,Single Family - Detached,442,415,27,0.0610859728506787
27.07,2020,Mobile Home,0,0,0,
27.07,2020,Multifamily,1145,1100,45,0.0393013100436681
27.07,2020,Single Family - Detached,442,408,34,0.0769230769230769
27.07,2025,Mobile Home,0,0,0,
27.07,2025,Multifamily,1145,1101,44,0.0384279475982533
27.07,2025,Single Family - Detached,442,412,30,0.0678733031674208
27.07,2030,Mobile Home,0,0,0,
27.07,2030,Multifamily,1145,1100,45,0.0393013100436681
27.07,2030,Single Family - Detached,442,410,32,0.0723981900452489
27.07,2035,Mobile Home,0,0,0,
27.07,2035,Multifamily,1145,1099,46,0.040174672489083
27.07,2035,Single Family - Detached,442,412,30,0.0678733031674208
27.07,2040,Mobile Home,0,0,0,
27.07,2040,Multifamily,1147,1100,47,0.040976460331299
27.07,2040,Single Family - Detached,442,410,32,0.0723981900452489
27.07,2045,Mobile Home,0,0,0,
27.07,2045,Multifamily,1230,1180,50,0.040650406504065
27.07,2045,Single Family - Detached,419,385,34,0.081145584725537
27.07,2050,Mobile Home,0,0,0,
27.07,2050,Multifamily,1925,1886,39,0.0202597402597403
27.07,2050,Single Family - Detached,154,148,6,0.038961038961039
27.08,2012,Mobile Home,0,0,0,
27.08,2012,Multifamily,1796,1749,47,0.0261692650334076
27.08,2012,Single Family - Detached,241,231,10,0.04149377593361
27.08,2020,Mobile Home,0,0,0,
27.08,2020,Multifamily,1796,1748,48,0.0267260579064588
27.08,2020,Single Family - Detached,241,220,21,0.0871369294605809
27.08,2025,Mobile Home,0,0,0,
27.08,2025,Multifamily,1796,1749,47,0.0261692650334076
27.08,2025,Single Family - Detached,241,228,13,0.0539419087136929
27.08,2030,Mobile Home,0,0,0,
27.08,2030,Multifamily,1796,1748,48,0.0267260579064588
27.08,2030,Single Family - Detached,241,225,16,0.0663900414937759
27.08,2035,Mobile Home,0,0,0,
27.08,2035,Multifamily,1796,1747,49,0.02728285077951
27.08,2035,Single Family - Detached,241,228,13,0.0539419087136929
27.08,2040,Mobile Home,0,0,0,
27.08,2040,Multifamily,1796,1742,54,0.0300668151447661
27.08,2040,Single Family - Detached,241,224,17,0.0705394190871369
27.08,2045,Mobile Home,0,0,0,
27.08,2045,Multifamily,1796,1737,59,0.0328507795100223
27.08,2045,Single Family - Detached,241,220,21,0.0871369294605809
27.08,2050,Mobile Home,0,0,0,
27.08,2050,Multifamily,3353,3313,40,0.0119296152699075
27.08,2050,Single Family - Detached,64,54,10,0.15625
27.09,2012,Mobile Home,0,0,0,
27.09,2012,Multifamily,536,502,34,0.0634328358208955
27.09,2012,Single Family - Detached,623,574,49,0.0786516853932584
27.09,2020,Mobile Home,0,0,0,
27.09,2020,Multifamily,540,495,45,0.0833333333333333
27.09,2020,Single Family - Detached,632,568,64,0.10126582278481
27.09,2025,Mobile Home,0,0,0,
27.09,2025,Multifamily,540,502,38,0.0703703703703704
27.09,2025,Single Family - Detached,632,575,57,0.0901898734177215
27.09,2030,Mobile Home,0,0,0,
27.09,2030,Multifamily,540,492,48,0.0888888888888889
27.09,2030,Single Family - Detached,632,573,59,0.0933544303797468
27.09,2035,Mobile Home,0,0,0,
27.09,2035,Multifamily,573,529,44,0.0767888307155323
27.09,2035,Single Family - Detached,632,575,57,0.0901898734177215
27.09,2040,Mobile Home,0,0,0,
27.09,2040,Multifamily,580,523,57,0.0982758620689655
27.09,2040,Single Family - Detached,632,572,60,0.0949367088607595
27.09,2045,Mobile Home,0,0,0,
27.09,2045,Multifamily,694,632,62,0.0893371757925072
27.09,2045,Single Family - Detached,603,569,34,0.0563847429519071
27.09,2050,Mobile Home,0,0,0,
27.09,2050,Multifamily,1005,959,46,0.045771144278607
27.09,2050,Single Family - Detached,542,529,13,0.0239852398523985
27.10,2012,Mobile Home,0,0,0,
27.10,2012,Multifamily,641,612,29,0.0452418096723869
27.10,2012,Single Family - Detached,583,528,55,0.0943396226415094
27.10,2020,Mobile Home,0,0,0,
27.10,2020,Multifamily,641,609,32,0.0499219968798752
27.10,2020,Single Family - Detached,579,549,30,0.0518134715025907
27.10,2025,Mobile Home,0,0,0,
27.10,2025,Multifamily,641,609,32,0.0499219968798752
27.10,2025,Single Family - Detached,579,554,25,0.0431778929188256
27.10,2030,Mobile Home,0,0,0,
27.10,2030,Multifamily,641,609,32,0.0499219968798752
27.10,2030,Single Family - Detached,579,551,28,0.0483592400690846
27.10,2035,Mobile Home,0,0,0,
27.10,2035,Multifamily,641,609,32,0.0499219968798752
27.10,2035,Single Family - Detached,579,554,25,0.0431778929188256
27.10,2040,Mobile Home,0,0,0,
27.10,2040,Multifamily,641,602,39,0.0608424336973479
27.10,2040,Single Family - Detached,579,551,28,0.0483592400690846
27.10,2045,Mobile Home,0,0,0,
27.10,2045,Multifamily,641,594,47,0.0733229329173167
27.10,2045,Single Family - Detached,579,548,31,0.0535405872193437
27.10,2050,Mobile Home,0,0,0,
27.10,2050,Multifamily,776,724,52,0.0670103092783505
27.10,2050,Single Family - Detached,543,508,35,0.0644567219152855
27.11,2012,Mobile Home,0,0,0,
27.11,2012,Multifamily,32,31,1,0.03125
27.11,2012,Single Family - Detached,890,864,26,0.0292134831460674
27.11,2020,Mobile Home,0,0,0,
27.11,2020,Multifamily,4,3,1,0.25
27.11,2020,Single Family - Detached,889,863,26,0.0292463442069741
27.11,2025,Mobile Home,0,0,0,
27.11,2025,Multifamily,4,4,0,0
27.11,2025,Single Family - Detached,889,865,24,0.0269966254218223
27.11,2030,Mobile Home,0,0,0,
27.11,2030,Multifamily,4,3,1,0.25
27.11,2030,Single Family - Detached,889,865,24,0.0269966254218223
27.11,2035,Mobile Home,0,0,0,
27.11,2035,Multifamily,93,91,2,0.021505376344086
27.11,2035,Single Family - Detached,889,865,24,0.0269966254218223
27.11,2040,Mobile Home,0,0,0,
27.11,2040,Multifamily,117,113,4,0.0341880341880342
27.11,2040,Single Family - Detached,889,865,24,0.0269966254218223
27.11,2045,Mobile Home,0,0,0,
27.11,2045,Multifamily,117,111,6,0.0512820512820513
27.11,2045,Single Family - Detached,889,864,25,0.0281214848143982
27.11,2050,Mobile Home,0,0,0,
27.11,2050,Multifamily,117,109,8,0.0683760683760684
27.11,2050,Single Family - Detached,889,864,25,0.0281214848143982
27.12,2012,Mobile Home,252,252,0,0
27.12,2012,Multifamily,951,914,37,0.0389064143007361
27.12,2012,Single Family - Detached,594,539,55,0.0925925925925926
27.12,2020,Mobile Home,252,252,0,0
27.12,2020,Multifamily,953,925,28,0.0293809024134313
27.12,2020,Single Family - Detached,594,538,56,0.0942760942760943
27.12,2025,Mobile Home,252,252,0,0
27.12,2025,Multifamily,965,939,26,0.0269430051813472
27.12,2025,Single Family - Detached,594,541,53,0.0892255892255892
27.12,2030,Mobile Home,252,251,1,0.00396825396825397
27.12,2030,Multifamily,1389,1355,34,0.0244780417566595
27.12,2030,Single Family - Detached,594,539,55,0.0925925925925926
27.12,2035,Mobile Home,252,251,1,0.00396825396825397
27.12,2035,Multifamily,2098,2052,46,0.0219256434699714
27.12,2035,Single Family - Detached,594,541,53,0.0892255892255892
27.12,2040,Mobile Home,252,252,0,0
27.12,2040,Multifamily,2120,2071,49,0.0231132075471698
27.12,2040,Single Family - Detached,594,538,56,0.0942760942760943
27.12,2045,Mobile Home,252,251,1,0.00396825396825397
27.12,2045,Multifamily,2120,2065,55,0.0259433962264151
27.12,2045,Single Family - Detached,594,533,61,0.102693602693603
27.12,2050,Mobile Home,252,246,6,0.0238095238095238
27.12,2050,Multifamily,2120,2057,63,0.0297169811320755
27.12,2050,Single Family - Detached,594,532,62,0.104377104377104
28.01,2012,Mobile Home,0,0,0,
28.01,2012,Multifamily,664,617,47,0.0707831325301205
28.01,2012,Single Family - Detached,475,441,34,0.071578947368421
28.01,2020,Mobile Home,0,0,0,
28.01,2020,Multifamily,1111,1092,19,0.0171017101710171
28.01,2020,Single Family - Detached,475,437,38,0.08
28.01,2025,Mobile Home,0,0,0,
28.01,2025,Multifamily,2140,2118,22,0.0102803738317757
28.01,2025,Single Family - Detached,470,437,33,0.0702127659574468
28.01,2030,Mobile Home,0,0,0,
28.01,2030,Multifamily,2496,2471,25,0.0100160256410256
28.01,2030,Single Family - Detached,470,436,34,0.0723404255319149
28.01,2035,Mobile Home,0,0,0,
28.01,2035,Multifamily,2496,2466,30,0.0120192307692308
28.01,2035,Single Family - Detached,470,437,33,0.0702127659574468
28.01,2040,Mobile Home,0,0,0,
28.01,2040,Multifamily,2496,2461,35,0.0140224358974359
28.01,2040,Single Family - Detached,470,436,34,0.0723404255319149
28.01,2045,Mobile Home,0,0,0,
28.01,2045,Multifamily,2496,2457,39,0.015625
28.01,2045,Single Family - Detached,470,436,34,0.0723404255319149
28.01,2050,Mobile Home,0,0,0,
28.01,2050,Multifamily,2496,2455,41,0.0164262820512821
28.01,2050,Single Family - Detached,470,436,34,0.0723404255319149
28.03,2012,Mobile Home,0,0,0,
28.03,2012,Multifamily,1469,1410,59,0.0401633764465623
28.03,2012,Single Family - Detached,1168,1137,31,0.026541095890411
28.03,2020,Mobile Home,0,0,0,
28.03,2020,Multifamily,1827,1788,39,0.0213464696223317
28.03,2020,Single Family - Detached,1167,1150,17,0.0145672664952871
28.03,2025,Mobile Home,0,0,0,
28.03,2025,Multifamily,2224,2180,44,0.0197841726618705
28.03,2025,Single Family - Detached,1167,1152,15,0.012853470437018
28.03,2030,Mobile Home,0,0,0,
28.03,2030,Multifamily,2224,2171,53,0.0238309352517986
28.03,2030,Single Family - Detached,1167,1151,16,0.0137103684661525
28.03,2035,Mobile Home,0,0,0,
28.03,2035,Multifamily,2419,2368,51,0.0210830921868541
28.03,2035,Single Family - Detached,1164,1152,12,0.0103092783505155
28.03,2040,Mobile Home,0,0,0,
28.03,2040,Multifamily,2585,2526,59,0.0228239845261122
28.03,2040,Single Family - Detached,1164,1149,15,0.0128865979381443
28.03,2045,Mobile Home,0,0,0,
28.03,2045,Multifamily,2585,2522,63,0.0243713733075435
28.03,2045,Single Family - Detached,1164,1147,17,0.0146048109965636
28.03,2050,Mobile Home,0,0,0,
28.03,2050,Multifamily,2585,2521,64,0.0247582205029014
28.03,2050,Single Family - Detached,1164,1146,18,0.0154639175257732
28.04,2012,Mobile Home,0,0,0,
28.04,2012,Multifamily,252,250,2,0.00793650793650794
28.04,2012,Single Family - Detached,1260,1224,36,0.0285714285714286
28.04,2020,Mobile Home,0,0,0,
28.04,2020,Multifamily,263,237,26,0.0988593155893536
28.04,2020,Single Family - Detached,1258,1225,33,0.0262321144674086
28.04,2025,Mobile Home,0,0,0,
28.04,2025,Multifamily,2118,2041,77,0.0363550519357885
28.04,2025,Single Family - Detached,1200,1176,24,0.02
28.04,2030,Mobile Home,0,0,0,
28.04,2030,Multifamily,2271,2189,82,0.0361074416556583
28.04,2030,Single Family - Detached,1201,1175,26,0.0216486261448793
28.04,2035,Mobile Home,0,0,0,
28.04,2035,Multifamily,2435,2349,86,0.0353182751540041
28.04,2035,Single Family - Detached,1201,1177,24,0.0199833472106578
28.04,2040,Mobile Home,0,0,0,
28.04,2040,Multifamily,2435,2331,104,0.0427104722792608
28.04,2040,Single Family - Detached,1202,1172,30,0.0249584026622296
28.04,2045,Mobile Home,0,0,0,
28.04,2045,Multifamily,2435,2316,119,0.048870636550308
28.04,2045,Single Family - Detached,1202,1167,35,0.0291181364392679
28.04,2050,Mobile Home,0,0,0,
28.04,2050,Multifamily,2435,2304,131,0.0537987679671458
28.04,2050,Single Family - Detached,1206,1170,36,0.0298507462686567
29.02,2012,Mobile Home,0,0,0,
29.02,2012,Multifamily,931,883,48,0.0515574650912997
29.02,2012,Single Family - Detached,1437,1379,58,0.0403618649965205
29.02,2020,Mobile Home,0,0,0,
29.02,2020,Multifamily,1245,1197,48,0.0385542168674699
29.02,2020,Single Family - Detached,1437,1377,60,0.0417536534446764
29.02,2025,Mobile Home,0,0,0,
29.02,2025,Multifamily,1245,1203,42,0.0337349397590361
29.02,2025,Single Family - Detached,1457,1403,54,0.0370624571036376
29.02,2030,Mobile Home,0,0,0,
29.02,2030,Multifamily,1245,1199,46,0.0369477911646586
29.02,2030,Single Family - Detached,1495,1444,51,0.0341137123745819
29.02,2035,Mobile Home,0,0,0,
29.02,2035,Multifamily,1216,1195,21,0.0172697368421053
29.02,2035,Single Family - Detached,1482,1442,40,0.0269905533063428
29.02,2040,Mobile Home,0,0,0,
29.02,2040,Multifamily,1214,1186,28,0.0230642504118616
29.02,2040,Single Family - Detached,1496,1444,52,0.0347593582887701
29.02,2045,Mobile Home,0,0,0,
29.02,2045,Multifamily,1729,1679,50,0.0289184499710816
29.02,2045,Single Family - Detached,1494,1429,65,0.0435073627844712
29.02,2050,Mobile Home,0,0,0,
29.02,2050,Multifamily,3401,3323,78,0.0229344310496913
29.02,2050,Single Family - Detached,1485,1417,68,0.0457912457912458
29.03,2012,Mobile Home,0,0,0,
29.03,2012,Multifamily,276,276,0,0
29.03,2012,Single Family - Detached,1123,1013,110,0.0979519145146928
29.03,2020,Mobile Home,0,0,0,
29.03,2020,Multifamily,276,274,2,0.0072463768115942
29.03,2020,Single Family - Detached,1123,1013,110,0.0979519145146928
29.03,2025,Mobile Home,0,0,0,
29.03,2025,Multifamily,276,275,1,0.0036231884057971
29.03,2025,Single Family - Detached,1123,1018,105,0.0934995547640249
29.03,2030,Mobile Home,0,0,0,
29.03,2030,Multifamily,276,275,1,0.0036231884057971
29.03,2030,Single Family - Detached,1123,1016,107,0.0952804986642921
29.03,2035,Mobile Home,0,0,0,
29.03,2035,Multifamily,228,225,3,0.0131578947368421
29.03,2035,Single Family - Detached,1123,1018,105,0.0934995547640249
29.03,2040,Mobile Home,0,0,0,
29.03,2040,Multifamily,228,220,8,0.0350877192982456
29.03,2040,Single Family - Detached,1123,1015,108,0.0961709706144256
29.03,2045,Mobile Home,0,0,0,
29.03,2045,Multifamily,499,483,16,0.032064128256513
29.03,2045,Single Family - Detached,1123,1012,111,0.0988423864648264
29.03,2050,Mobile Home,0,0,0,
29.03,2050,Multifamily,924,900,24,0.025974025974026
29.03,2050,Single Family - Detached,1112,1000,112,0.100719424460432
29.04,2012,Mobile Home,0,0,0,
29.04,2012,Multifamily,1075,1070,5,0.00465116279069767
29.04,2012,Single Family - Detached,1065,1061,4,0.00375586854460094
29.04,2020,Mobile Home,0,0,0,
29.04,2020,Multifamily,1225,1192,33,0.0269387755102041
29.04,2020,Single Family - Detached,1068,1058,10,0.00936329588014981
29.04,2025,Mobile Home,0,0,0,
29.04,2025,Multifamily,1188,1152,36,0.0303030303030303
29.04,2025,Single Family - Detached,1066,1060,6,0.00562851782363977
29.04,2030,Mobile Home,0,0,0,
29.04,2030,Multifamily,3376,3269,107,0.0316943127962085
29.04,2030,Single Family - Detached,1040,1036,4,0.00384615384615385
29.04,2035,Mobile Home,0,0,0,
29.04,2035,Multifamily,4912,4785,127,0.0258550488599349
29.04,2035,Single Family - Detached,1040,1036,4,0.00384615384615385
29.04,2040,Mobile Home,0,0,0,
29.04,2040,Multifamily,4946,4801,145,0.0293166194904974
29.04,2040,Single Family - Detached,1040,1036,4,0.00384615384615385
29.04,2045,Mobile Home,0,0,0,
29.04,2045,Multifamily,5003,4846,157,0.0313811712972217
29.04,2045,Single Family - Detached,1040,1036,4,0.00384615384615385
29.04,2050,Mobile Home,0,0,0,
29.04,2050,Multifamily,5018,4853,165,0.0328816261458749
29.04,2050,Single Family - Detached,1042,1038,4,0.00383877159309021
29.05,2012,Mobile Home,0,0,0,
29.05,2012,Multifamily,734,707,27,0.0367847411444142
29.05,2012,Single Family - Detached,972,927,45,0.0462962962962963
29.05,2020,Mobile Home,0,0,0,
29.05,2020,Multifamily,734,668,66,0.0899182561307902
29.05,2020,Single Family - Detached,972,914,58,0.0596707818930041
29.05,2025,Mobile Home,0,0,0,
29.05,2025,Multifamily,734,651,83,0.113079019073569
29.05,2025,Single Family - Detached,972,927,45,0.0462962962962963
29.05,2030,Mobile Home,0,0,0,
29.05,2030,Multifamily,734,643,91,0.123978201634877
29.05,2030,Single Family - Detached,972,926,46,0.0473251028806584
29.05,2035,Mobile Home,0,0,0,
29.05,2035,Multifamily,2836,2686,150,0.0528913963328632
29.05,2035,Single Family - Detached,799,765,34,0.0425531914893617
29.05,2040,Mobile Home,0,0,0,
29.05,2040,Multifamily,2987,2830,157,0.0525610980917308
29.05,2040,Single Family - Detached,807,774,33,0.0408921933085502
29.05,2045,Mobile Home,0,0,0,
29.05,2045,Multifamily,3240,3075,165,0.0509259259259259
29.05,2045,Single Family - Detached,770,731,39,0.0506493506493507
29.05,2050,Mobile Home,0,0,0,
29.05,2050,Multifamily,3506,3342,164,0.0467769537934969
29.05,2050,Single Family - Detached,770,728,42,0.0545454545454545
3,2012,Mobile Home,0,0,0,
3,2012,Multifamily,2592,2350,242,0.0933641975308642
3,2012,Single Family - Detached,556,537,19,0.0341726618705036
3,2020,Mobile Home,0,0,0,
3,2020,Multifamily,2643,2381,262,0.0991297767688233
3,2020,Single Family - Detached,587,557,30,0.0511073253833049
3,2025,Mobile Home,0,0,0,
3,2025,Multifamily,2794,2597,197,0.0705082319255548
3,2025,Single Family - Detached,565,543,22,0.0389380530973451
3,2030,Mobile Home,0,0,0,
3,2030,Multifamily,2828,2591,237,0.0838048090523338
3,2030,Single Family - Detached,565,539,26,0.0460176991150442
3,2035,Mobile Home,0,0,0,
3,2035,Multifamily,2797,2578,219,0.0782981766178048
3,2035,Single Family - Detached,563,540,23,0.0408525754884547
3,2040,Mobile Home,0,0,0,
3,2040,Multifamily,3016,2742,274,0.0908488063660478
3,2040,Single Family - Detached,548,510,38,0.0693430656934307
3,2045,Mobile Home,0,0,0,
3,2045,Multifamily,3693,3399,294,0.0796100731112916
3,2045,Single Family - Detached,502,464,38,0.0756972111553785
3,2050,Mobile Home,0,0,0,
3,2050,Multifamily,4543,4274,269,0.0592119744662118
3,2050,Single Family - Detached,419,397,22,0.0525059665871122
30.01,2012,Mobile Home,0,0,0,
30.01,2012,Multifamily,3,0,3,1
30.01,2012,Single Family - Detached,1237,1195,42,0.0339531123686338
30.01,2020,Mobile Home,0,0,0,
30.01,2020,Multifamily,3,1,2,0.666666666666667
30.01,2020,Single Family - Detached,1296,1244,52,0.0401234567901235
30.01,2025,Mobile Home,0,0,0,
30.01,2025,Multifamily,37,35,2,0.0540540540540541
30.01,2025,Single Family - Detached,1276,1238,38,0.0297805642633229
30.01,2030,Mobile Home,0,0,0,
30.01,2030,Multifamily,37,34,3,0.0810810810810811
30.01,2030,Single Family - Detached,1276,1218,58,0.0454545454545455
30.01,2035,Mobile Home,0,0,0,
30.01,2035,Multifamily,37,34,3,0.0810810810810811
30.01,2035,Single Family - Detached,1276,1221,55,0.0431034482758621
30.01,2040,Mobile Home,0,0,0,
30.01,2040,Multifamily,41,36,5,0.121951219512195
30.01,2040,Single Family - Detached,1276,1215,61,0.0478056426332288
30.01,2045,Mobile Home,0,0,0,
30.01,2045,Multifamily,41,34,7,0.170731707317073
30.01,2045,Single Family - Detached,1276,1193,83,0.0650470219435737
30.01,2050,Mobile Home,0,0,0,
30.01,2050,Multifamily,41,33,8,0.195121951219512
30.01,2050,Single Family - Detached,1276,1192,84,0.0658307210031348
30.03,2012,Mobile Home,0,0,0,
30.03,2012,Multifamily,6,6,0,0
30.03,2012,Single Family - Detached,1573,1535,38,0.0241576605212969
30.03,2020,Mobile Home,0,0,0,
30.03,2020,Multifamily,6,6,0,0
30.03,2020,Single Family - Detached,1699,1649,50,0.0294290759270159
30.03,2025,Mobile Home,0,0,0,
30.03,2025,Multifamily,6,6,0,0
30.03,2025,Single Family - Detached,1732,1693,39,0.0225173210161663
30.03,2030,Mobile Home,0,0,0,
30.03,2030,Multifamily,6,6,0,0
30.03,2030,Single Family - Detached,1841,1816,25,0.0135795763172189
30.03,2035,Mobile Home,0,0,0,
30.03,2035,Multifamily,6,6,0,0
30.03,2035,Single Family - Detached,1869,1848,21,0.0112359550561798
30.03,2040,Mobile Home,0,0,0,
30.03,2040,Multifamily,6,5,1,0.166666666666667
30.03,2040,Single Family - Detached,1869,1844,25,0.0133761369716426
30.03,2045,Mobile Home,0,0,0,
30.03,2045,Multifamily,6,4,2,0.333333333333333
30.03,2045,Single Family - Detached,1880,1841,39,0.0207446808510638
30.03,2050,Mobile Home,0,0,0,
30.03,2050,Multifamily,6,3,3,0.5
30.03,2050,Single Family - Detached,1880,1840,40,0.0212765957446809
30.04,2012,Mobile Home,0,0,0,
30.04,2012,Multifamily,305,295,10,0.0327868852459016
30.04,2012,Single Family - Detached,1041,992,49,0.0470701248799232
30.04,2020,Mobile Home,0,0,0,
30.04,2020,Multifamily,305,297,8,0.0262295081967213
30.04,2020,Single Family - Detached,1043,986,57,0.0546500479386385
30.04,2025,Mobile Home,0,0,0,
30.04,2025,Multifamily,305,296,9,0.0295081967213115
30.04,2025,Single Family - Detached,1048,998,50,0.0477099236641221
30.04,2030,Mobile Home,0,0,0,
30.04,2030,Multifamily,305,295,10,0.0327868852459016
30.04,2030,Single Family - Detached,1075,1029,46,0.0427906976744186
30.04,2035,Mobile Home,0,0,0,
30.04,2035,Multifamily,305,297,8,0.0262295081967213
30.04,2035,Single Family - Detached,1075,1030,45,0.0418604651162791
30.04,2040,Mobile Home,0,0,0,
30.04,2040,Multifamily,328,312,16,0.0487804878048781
30.04,2040,Single Family - Detached,1070,1022,48,0.0448598130841121
30.04,2045,Mobile Home,0,0,0,
30.04,2045,Multifamily,379,366,13,0.0343007915567282
30.04,2045,Single Family - Detached,1080,1060,20,0.0185185185185185
30.04,2050,Mobile Home,0,0,0,
30.04,2050,Multifamily,379,365,14,0.0369393139841689
30.04,2050,Single Family - Detached,1080,1060,20,0.0185185185185185
31.01,2012,Mobile Home,0,0,0,
31.01,2012,Multifamily,0,0,0,
31.01,2012,Single Family - Detached,1086,1054,32,0.0294659300184162
31.01,2020,Mobile Home,0,0,0,
31.01,2020,Multifamily,0,0,0,
31.01,2020,Single Family - Detached,1128,1118,10,0.00886524822695036
31.01,2025,Mobile Home,0,0,0,
31.01,2025,Multifamily,0,0,0,
31.01,2025,Single Family - Detached,1128,1119,9,0.00797872340425532
31.01,2030,Mobile Home,0,0,0,
31.01,2030,Multifamily,0,0,0,
31.01,2030,Single Family - Detached,1128,1118,10,0.00886524822695036
31.01,2035,Mobile Home,0,0,0,
31.01,2035,Multifamily,0,0,0,
31.01,2035,Single Family - Detached,1128,1119,9,0.00797872340425532
31.01,2040,Mobile Home,0,0,0,
31.01,2040,Multifamily,0,0,0,
31.01,2040,Single Family - Detached,1128,1118,10,0.00886524822695036
31.01,2045,Mobile Home,0,0,0,
31.01,2045,Multifamily,0,0,0,
31.01,2045,Single Family - Detached,1128,1117,11,0.00975177304964539
31.01,2050,Mobile Home,0,0,0,
31.01,2050,Multifamily,0,0,0,
31.01,2050,Single Family - Detached,1128,1116,12,0.0106382978723404
31.03,2012,Mobile Home,0,0,0,
31.03,2012,Multifamily,6,6,0,0
31.03,2012,Single Family - Detached,1664,1600,64,0.0384615384615385
31.03,2020,Mobile Home,0,0,0,
31.03,2020,Multifamily,6,6,0,0
31.03,2020,Single Family - Detached,1755,1712,43,0.0245014245014245
31.03,2025,Mobile Home,0,0,0,
31.03,2025,Multifamily,8,8,0,0
31.03,2025,Single Family - Detached,1769,1734,35,0.0197851893725269
31.03,2030,Mobile Home,0,0,0,
31.03,2030,Multifamily,8,8,0,0
31.03,2030,Single Family - Detached,1787,1778,9,0.00503637381085618
31.03,2035,Mobile Home,0,0,0,
31.03,2035,Multifamily,8,8,0,0
31.03,2035,Single Family - Detached,1787,1779,8,0.00447677672076105
31.03,2040,Mobile Home,0,0,0,
31.03,2040,Multifamily,8,7,1,0.125
31.03,2040,Single Family - Detached,1797,1786,11,0.00612131329994435
31.03,2045,Mobile Home,0,0,0,
31.03,2045,Multifamily,8,7,1,0.125
31.03,2045,Single Family - Detached,1798,1784,14,0.00778642936596218
31.03,2050,Mobile Home,0,0,0,
31.03,2050,Multifamily,8,7,1,0.125
31.03,2050,Single Family - Detached,1798,1784,14,0.00778642936596218
31.05,2012,Mobile Home,0,0,0,
31.05,2012,Multifamily,0,0,0,
31.05,2012,Single Family - Detached,1061,1024,37,0.0348727615457116
31.05,2020,Mobile Home,0,0,0,
31.05,2020,Multifamily,0,0,0,
31.05,2020,Single Family - Detached,1061,1019,42,0.0395852968897267
31.05,2025,Mobile Home,0,0,0,
31.05,2025,Multifamily,0,0,0,
31.05,2025,Single Family - Detached,1061,1024,37,0.0348727615457116
31.05,2030,Mobile Home,0,0,0,
31.05,2030,Multifamily,0,0,0,
31.05,2030,Single Family - Detached,1061,1020,41,0.0386427898209237
31.05,2035,Mobile Home,0,0,0,
31.05,2035,Multifamily,0,0,0,
31.05,2035,Single Family - Detached,1061,1020,41,0.0386427898209237
31.05,2040,Mobile Home,0,0,0,
31.05,2040,Multifamily,0,0,0,
31.05,2040,Single Family - Detached,1081,1039,42,0.0388529139685476
31.05,2045,Mobile Home,0,0,0,
31.05,2045,Multifamily,0,0,0,
31.05,2045,Single Family - Detached,1083,1038,45,0.0415512465373961
31.05,2050,Mobile Home,0,0,0,
31.05,2050,Multifamily,0,0,0,
31.05,2050,Single Family - Detached,1083,1038,45,0.0415512465373961
31.07,2012,Mobile Home,0,0,0,
31.07,2012,Multifamily,122,122,0,0
31.07,2012,Single Family - Detached,1502,1449,53,0.0352862849533955
31.07,2020,Mobile Home,0,0,0,
31.07,2020,Multifamily,122,122,0,0
31.07,2020,Single Family - Detached,1502,1439,63,0.0419440745672437
31.07,2025,Mobile Home,0,0,0,
31.07,2025,Multifamily,122,122,0,0
31.07,2025,Single Family - Detached,1502,1449,53,0.0352862849533955
31.07,2030,Mobile Home,0,0,0,
31.07,2030,Multifamily,122,122,0,0
31.07,2030,Single Family - Detached,1502,1439,63,0.0419440745672437
31.07,2035,Mobile Home,0,0,0,
31.07,2035,Multifamily,122,122,0,0
31.07,2035,Single Family - Detached,1502,1441,61,0.040612516644474
31.07,2040,Mobile Home,0,0,0,
31.07,2040,Multifamily,122,122,0,0
31.07,2040,Single Family - Detached,1502,1434,68,0.0452729693741678
31.07,2045,Mobile Home,0,0,0,
31.07,2045,Multifamily,122,122,0,0
31.07,2045,Single Family - Detached,1510,1441,69,0.0456953642384106
31.07,2050,Mobile Home,0,0,0,
31.07,2050,Multifamily,122,122,0,0
31.07,2050,Single Family - Detached,1510,1441,69,0.0456953642384106
31.08,2012,Mobile Home,0,0,0,
31.08,2012,Multifamily,86,86,0,0
31.08,2012,Single Family - Detached,895,866,29,0.0324022346368715
31.08,2020,Mobile Home,0,0,0,
31.08,2020,Multifamily,86,82,4,0.0465116279069767
31.08,2020,Single Family - Detached,895,861,34,0.0379888268156425
31.08,2025,Mobile Home,0,0,0,
31.08,2025,Multifamily,86,82,4,0.0465116279069767
31.08,2025,Single Family - Detached,895,861,34,0.0379888268156425
31.08,2030,Mobile Home,0,0,0,
31.08,2030,Multifamily,86,82,4,0.0465116279069767
31.08,2030,Single Family - Detached,895,861,34,0.0379888268156425
31.08,2035,Mobile Home,0,0,0,
31.08,2035,Multifamily,86,82,4,0.0465116279069767
31.08,2035,Single Family - Detached,895,861,34,0.0379888268156425
31.08,2040,Mobile Home,0,0,0,
31.08,2040,Multifamily,86,82,4,0.0465116279069767
31.08,2040,Single Family - Detached,895,857,38,0.0424581005586592
31.08,2045,Mobile Home,0,0,0,
31.08,2045,Multifamily,86,82,4,0.0465116279069767
31.08,2045,Single Family - Detached,895,846,49,0.0547486033519553
31.08,2050,Mobile Home,0,0,0,
31.08,2050,Multifamily,86,80,6,0.0697674418604651
31.08,2050,Single Family - Detached,895,845,50,0.0558659217877095
31.09,2012,Mobile Home,0,0,0,
31.09,2012,Multifamily,46,46,0,0
31.09,2012,Single Family - Detached,781,771,10,0.0128040973111396
31.09,2020,Mobile Home,0,0,0,
31.09,2020,Multifamily,46,46,0,0
31.09,2020,Single Family - Detached,782,767,15,0.0191815856777494
31.09,2025,Mobile Home,0,0,0,
31.09,2025,Multifamily,48,48,0,0
31.09,2025,Single Family - Detached,785,775,10,0.0127388535031847
31.09,2030,Mobile Home,0,0,0,
31.09,2030,Multifamily,48,48,0,0
31.09,2030,Single Family - Detached,788,775,13,0.016497461928934
31.09,2035,Mobile Home,0,0,0,
31.09,2035,Multifamily,48,48,0,0
31.09,2035,Single Family - Detached,788,775,13,0.016497461928934
31.09,2040,Mobile Home,0,0,0,
31.09,2040,Multifamily,48,48,0,0
31.09,2040,Single Family - Detached,788,775,13,0.016497461928934
31.09,2045,Mobile Home,0,0,0,
31.09,2045,Multifamily,48,48,0,0
31.09,2045,Single Family - Detached,788,772,16,0.0203045685279188
31.09,2050,Mobile Home,0,0,0,
31.09,2050,Multifamily,48,48,0,0
31.09,2050,Single Family - Detached,788,772,16,0.0203045685279188
31.11,2012,Mobile Home,95,95,0,0
31.11,2012,Multifamily,407,403,4,0.00982800982800983
31.11,2012,Single Family - Detached,1176,1114,62,0.0527210884353742
31.11,2020,Mobile Home,95,95,0,0
31.11,2020,Multifamily,407,405,2,0.00491400491400491
31.11,2020,Single Family - Detached,1179,1103,76,0.0644614079728583
31.11,2025,Mobile Home,95,95,0,0
31.11,2025,Multifamily,664,662,2,0.00301204819277108
31.11,2025,Single Family - Detached,1120,1056,64,0.0571428571428571
31.11,2030,Mobile Home,95,94,1,0.0105263157894737
31.11,2030,Multifamily,674,674,0,0
31.11,2030,Single Family - Detached,1148,1096,52,0.0452961672473868
31.11,2035,Mobile Home,95,94,1,0.0105263157894737
31.11,2035,Multifamily,679,678,1,0.00147275405007364
31.11,2035,Single Family - Detached,1148,1100,48,0.0418118466898955
31.11,2040,Mobile Home,0,0,0,
31.11,2040,Multifamily,1076,1077,-1,-0.000929368029739777
31.11,2040,Single Family - Detached,1086,1039,47,0.0432780847145488
31.11,2045,Mobile Home,0,0,0,
31.11,2045,Multifamily,1089,1087,2,0.00183654729109275
31.11,2045,Single Family - Detached,1086,1024,62,0.0570902394106814
31.11,2050,Mobile Home,0,0,0,
31.11,2050,Multifamily,1097,1094,3,0.00273473108477666
31.11,2050,Single Family - Detached,1086,1022,64,0.0589318600368324
31.12,2012,Mobile Home,250,250,0,0
31.12,2012,Multifamily,41,39,2,0.0487804878048781
31.12,2012,Single Family - Detached,936,918,18,0.0192307692307692
31.12,2020,Mobile Home,250,250,0,0
31.12,2020,Multifamily,41,40,1,0.024390243902439
31.12,2020,Single Family - Detached,968,944,24,0.0247933884297521
31.12,2025,Mobile Home,250,250,0,0
31.12,2025,Multifamily,41,40,1,0.024390243902439
31.12,2025,Single Family - Detached,1015,999,16,0.0157635467980296
31.12,2030,Mobile Home,250,249,1,0.004
31.12,2030,Multifamily,41,40,1,0.024390243902439
31.12,2030,Single Family - Detached,1084,1055,29,0.0267527675276753
31.12,2035,Mobile Home,250,249,1,0.004
31.12,2035,Multifamily,41,40,1,0.024390243902439
31.12,2035,Single Family - Detached,1171,1146,25,0.0213492741246798
31.12,2040,Mobile Home,250,250,0,0
31.12,2040,Multifamily,271,266,5,0.018450184501845
31.12,2040,Single Family - Detached,1171,1141,30,0.0256191289496157
31.12,2045,Mobile Home,118,117,1,0.00847457627118644
31.12,2045,Multifamily,465,457,8,0.0172043010752688
31.12,2045,Single Family - Detached,1234,1203,31,0.0251215559157212
31.12,2050,Mobile Home,2,2,0,0
31.12,2050,Multifamily,620,612,8,0.0129032258064516
31.12,2050,Single Family - Detached,1234,1202,32,0.0259319286871961
31.13,2012,Mobile Home,0,0,0,
31.13,2012,Multifamily,0,0,0,
31.13,2012,Single Family - Detached,1281,1260,21,0.0163934426229508
31.13,2020,Mobile Home,0,0,0,
31.13,2020,Multifamily,0,0,0,
31.13,2020,Single Family - Detached,1281,1251,30,0.0234192037470726
31.13,2025,Mobile Home,0,0,0,
31.13,2025,Multifamily,0,0,0,
31.13,2025,Single Family - Detached,1281,1259,22,0.0171740827478532
31.13,2030,Mobile Home,0,0,0,
31.13,2030,Multifamily,0,0,0,
31.13,2030,Single Family - Detached,1281,1250,31,0.024199843871975
31.13,2035,Mobile Home,0,0,0,
31.13,2035,Multifamily,0,0,0,
31.13,2035,Single Family - Detached,1290,1262,28,0.0217054263565891
31.13,2040,Mobile Home,0,0,0,
31.13,2040,Multifamily,0,0,0,
31.13,2040,Single Family - Detached,1290,1257,33,0.0255813953488372
31.13,2045,Mobile Home,0,0,0,
31.13,2045,Multifamily,0,0,0,
31.13,2045,Single Family - Detached,1357,1315,42,0.0309506263817244
31.13,2050,Mobile Home,0,0,0,
31.13,2050,Multifamily,0,0,0,
31.13,2050,Single Family - Detached,1358,1314,44,0.03240058910162
31.14,2012,Mobile Home,0,0,0,
31.14,2012,Multifamily,0,0,0,
31.14,2012,Single Family - Detached,810,789,21,0.0259259259259259
31.14,2020,Mobile Home,0,0,0,
31.14,2020,Multifamily,0,0,0,
31.14,2020,Single Family - Detached,810,775,35,0.0432098765432099
31.14,2025,Mobile Home,0,0,0,
31.14,2025,Multifamily,0,0,0,
31.14,2025,Single Family - Detached,810,789,21,0.0259259259259259
31.14,2030,Mobile Home,0,0,0,
31.14,2030,Multifamily,0,0,0,
31.14,2030,Single Family - Detached,844,821,23,0.0272511848341232
31.14,2035,Mobile Home,0,0,0,
31.14,2035,Multifamily,0,0,0,
31.14,2035,Single Family - Detached,844,821,23,0.0272511848341232
31.14,2040,Mobile Home,0,0,0,
31.14,2040,Multifamily,0,0,0,
31.14,2040,Single Family - Detached,848,820,28,0.0330188679245283
31.14,2045,Mobile Home,0,0,0,
31.14,2045,Multifamily,0,0,0,
31.14,2045,Single Family - Detached,848,812,36,0.0424528301886792
31.14,2050,Mobile Home,0,0,0,
31.14,2050,Multifamily,0,0,0,
31.14,2050,Single Family - Detached,848,812,36,0.0424528301886792
31.15,2012,Mobile Home,0,0,0,
31.15,2012,Multifamily,448,448,0,0
31.15,2012,Single Family - Detached,1331,1281,50,0.0375657400450789
31.15,2020,Mobile Home,0,0,0,
31.15,2020,Multifamily,448,448,0,0
31.15,2020,Single Family - Detached,1331,1268,63,0.0473328324567994
31.15,2025,Mobile Home,0,0,0,
31.15,2025,Multifamily,600,600,0,0
31.15,2025,Single Family - Detached,1331,1280,51,0.0383170548459805
31.15,2030,Mobile Home,0,0,0,
31.15,2030,Multifamily,603,603,0,0
31.15,2030,Single Family - Detached,1331,1270,61,0.0458302028549962
31.15,2035,Mobile Home,0,0,0,
31.15,2035,Multifamily,603,603,0,0
31.15,2035,Single Family - Detached,1331,1272,59,0.0443275732531931
31.15,2040,Mobile Home,0,0,0,
31.15,2040,Multifamily,606,606,0,0
31.15,2040,Single Family - Detached,1331,1264,67,0.0503380916604057
31.15,2045,Mobile Home,0,0,0,
31.15,2045,Multifamily,607,607,0,0
31.15,2045,Single Family - Detached,1337,1261,76,0.0568436798803291
31.15,2050,Mobile Home,0,0,0,
31.15,2050,Multifamily,607,607,0,0
31.15,2050,Single Family - Detached,1337,1261,76,0.0568436798803291
32.01,2012,Mobile Home,0,0,0,
32.01,2012,Multifamily,106,95,11,0.10377358490566
32.01,2012,Single Family - Detached,1398,1362,36,0.0257510729613734
32.01,2020,Mobile Home,0,0,0,
32.01,2020,Multifamily,106,96,10,0.0943396226415094
32.01,2020,Single Family - Detached,1520,1477,43,0.0282894736842105
32.01,2025,Mobile Home,0,0,0,
32.01,2025,Multifamily,124,122,2,0.0161290322580645
32.01,2025,Single Family - Detached,1520,1480,40,0.0263157894736842
32.01,2030,Mobile Home,0,0,0,
32.01,2030,Multifamily,125,122,3,0.024
32.01,2030,Single Family - Detached,1520,1478,42,0.0276315789473684
32.01,2035,Mobile Home,0,0,0,
32.01,2035,Multifamily,125,122,3,0.024
32.01,2035,Single Family - Detached,1520,1478,42,0.0276315789473684
32.01,2040,Mobile Home,0,0,0,
32.01,2040,Multifamily,125,121,4,0.032
32.01,2040,Single Family - Detached,1520,1475,45,0.0296052631578947
32.01,2045,Mobile Home,0,0,0,
32.01,2045,Multifamily,125,121,4,0.032
32.01,2045,Single Family - Detached,1520,1472,48,0.0315789473684211
32.01,2050,Mobile Home,0,0,0,
32.01,2050,Multifamily,125,121,4,0.032
32.01,2050,Single Family - Detached,1520,1470,50,0.0328947368421053
32.02,2012,Mobile Home,83,70,13,0.156626506024096
32.02,2012,Multifamily,19,17,2,0.105263157894737
32.02,2012,Single Family - Detached,1218,1197,21,0.0172413793103448
32.02,2020,Mobile Home,83,71,12,0.144578313253012
32.02,2020,Multifamily,19,18,1,0.0526315789473684
32.02,2020,Single Family - Detached,1710,1664,46,0.0269005847953216
32.02,2025,Mobile Home,75,64,11,0.146666666666667
32.02,2025,Multifamily,40,35,5,0.125
32.02,2025,Single Family - Detached,1717,1677,40,0.023296447291788
32.02,2030,Mobile Home,63,54,9,0.142857142857143
32.02,2030,Multifamily,67,61,6,0.0895522388059701
32.02,2030,Single Family - Detached,1717,1677,40,0.023296447291788
32.02,2035,Mobile Home,54,47,7,0.12962962962963
32.02,2035,Multifamily,85,81,4,0.0470588235294118
32.02,2035,Single Family - Detached,1734,1694,40,0.0230680507497117
32.02,2040,Mobile Home,25,22,3,0.12
32.02,2040,Multifamily,144,137,7,0.0486111111111111
32.02,2040,Single Family - Detached,1737,1691,46,0.026482440990213
32.02,2045,Mobile Home,0,0,0,
32.02,2045,Multifamily,194,185,9,0.0463917525773196
32.02,2045,Single Family - Detached,1738,1686,52,0.0299194476409666
32.02,2050,Mobile Home,0,0,0,
32.02,2050,Multifamily,194,184,10,0.0515463917525773
32.02,2050,Single Family - Detached,1738,1685,53,0.0304948216340621
32.04,2012,Mobile Home,0,0,0,
32.04,2012,Multifamily,0,0,0,
32.04,2012,Single Family - Detached,1101,1037,64,0.0581289736603088
32.04,2020,Mobile Home,0,0,0,
32.04,2020,Multifamily,0,0,0,
32.04,2020,Single Family - Detached,1101,1033,68,0.0617620345140781
32.04,2025,Mobile Home,0,0,0,
32.04,2025,Multifamily,0,0,0,
32.04,2025,Single Family - Detached,1119,1061,58,0.0518319928507596
32.04,2030,Mobile Home,0,0,0,
32.04,2030,Multifamily,0,0,0,
32.04,2030,Single Family - Detached,1130,1068,62,0.0548672566371681
32.04,2035,Mobile Home,0,0,0,
32.04,2035,Multifamily,0,0,0,
32.04,2035,Single Family - Detached,1130,1070,60,0.0530973451327434
32.04,2040,Mobile Home,0,0,0,
32.04,2040,Multifamily,0,0,0,
32.04,2040,Single Family - Detached,1135,1051,84,0.0740088105726872
32.04,2045,Mobile Home,0,0,0,
32.04,2045,Multifamily,0,0,0,
32.04,2045,Single Family - Detached,1136,1051,85,0.0748239436619718
32.04,2050,Mobile Home,0,0,0,
32.04,2050,Multifamily,0,0,0,
32.04,2050,Single Family - Detached,1167,1082,85,0.0728363324764353
32.07,2012,Mobile Home,0,0,0,
32.07,2012,Multifamily,792,784,8,0.0101010101010101
32.07,2012,Single Family - Detached,1382,1341,41,0.0296671490593343
32.07,2020,Mobile Home,0,0,0,
32.07,2020,Multifamily,788,780,8,0.0101522842639594
32.07,2020,Single Family - Detached,1411,1369,42,0.0297661233167966
32.07,2025,Mobile Home,0,0,0,
32.07,2025,Multifamily,772,764,8,0.0103626943005181
32.07,2025,Single Family - Detached,1412,1378,34,0.0240793201133144
32.07,2030,Mobile Home,0,0,0,
32.07,2030,Multifamily,772,764,8,0.0103626943005181
32.07,2030,Single Family - Detached,1414,1375,39,0.0275813295615276
32.07,2035,Mobile Home,0,0,0,
32.07,2035,Multifamily,772,764,8,0.0103626943005181
32.07,2035,Single Family - Detached,1414,1376,38,0.0268741159830269
32.07,2040,Mobile Home,0,0,0,
32.07,2040,Multifamily,1117,1107,10,0.00895255147717099
32.07,2040,Single Family - Detached,1284,1245,39,0.0303738317757009
32.07,2045,Mobile Home,0,0,0,
32.07,2045,Multifamily,1363,1351,12,0.00880410858400587
32.07,2045,Single Family - Detached,1214,1171,43,0.0354200988467875
32.07,2050,Mobile Home,0,0,0,
32.07,2050,Multifamily,1363,1350,13,0.00953778429933969
32.07,2050,Single Family - Detached,1215,1170,45,0.037037037037037
32.08,2012,Mobile Home,0,0,0,
32.08,2012,Multifamily,778,763,15,0.019280205655527
32.08,2012,Single Family - Detached,1509,1437,72,0.047713717693837
32.08,2020,Mobile Home,0,0,0,
32.08,2020,Multifamily,778,765,13,0.0167095115681234
32.08,2020,Single Family - Detached,1560,1515,45,0.0288461538461538
32.08,2025,Mobile Home,0,0,0,
32.08,2025,Multifamily,778,764,14,0.0179948586118252
32.08,2025,Single Family - Detached,1749,1735,14,0.00800457404230989
32.08,2030,Mobile Home,0,0,0,
32.08,2030,Multifamily,778,764,14,0.0179948586118252
32.08,2030,Single Family - Detached,1848,1832,16,0.00865800865800866
32.08,2035,Mobile Home,0,0,0,
32.08,2035,Multifamily,778,764,14,0.0179948586118252
32.08,2035,Single Family - Detached,1848,1832,16,0.00865800865800866
32.08,2040,Mobile Home,0,0,0,
32.08,2040,Multifamily,783,768,15,0.0191570881226054
32.08,2040,Single Family - Detached,1848,1830,18,0.00974025974025974
32.08,2045,Mobile Home,0,0,0,
32.08,2045,Multifamily,784,769,15,0.0191326530612245
32.08,2045,Single Family - Detached,1848,1828,20,0.0108225108225108
32.08,2050,Mobile Home,0,0,0,
32.08,2050,Multifamily,784,769,15,0.0191326530612245
32.08,2050,Single Family - Detached,1848,1826,22,0.0119047619047619
32.09,2012,Mobile Home,0,0,0,
32.09,2012,Multifamily,806,806,0,0
32.09,2012,Single Family - Detached,959,902,57,0.059436913451512
32.09,2020,Mobile Home,0,0,0,
32.09,2020,Multifamily,806,806,0,0
32.09,2020,Single Family - Detached,971,919,52,0.0535530381050463
32.09,2025,Mobile Home,0,0,0,
32.09,2025,Multifamily,806,806,0,0
32.09,2025,Single Family - Detached,971,919,52,0.0535530381050463
32.09,2030,Mobile Home,0,0,0,
32.09,2030,Multifamily,806,806,0,0
32.09,2030,Single Family - Detached,1072,1019,53,0.0494402985074627
32.09,2035,Mobile Home,0,0,0,
32.09,2035,Multifamily,806,806,0,0
32.09,2035,Single Family - Detached,1255,1224,31,0.0247011952191235
32.09,2040,Mobile Home,0,0,0,
32.09,2040,Multifamily,806,806,0,0
32.09,2040,Single Family - Detached,1283,1252,31,0.0241621200311769
32.09,2045,Mobile Home,0,0,0,
32.09,2045,Multifamily,812,812,0,0
32.09,2045,Single Family - Detached,1288,1257,31,0.0240683229813665
32.09,2050,Mobile Home,0,0,0,
32.09,2050,Multifamily,812,812,0,0
32.09,2050,Single Family - Detached,1290,1259,31,0.024031007751938
32.11,2012,Mobile Home,0,0,0,
32.11,2012,Multifamily,53,50,3,0.0566037735849057
32.11,2012,Single Family - Detached,837,821,16,0.019115890083632
32.11,2020,Mobile Home,0,0,0,
32.11,2020,Multifamily,53,51,2,0.0377358490566038
32.11,2020,Single Family - Detached,841,810,31,0.0368608799048751
32.11,2025,Mobile Home,0,0,0,
32.11,2025,Multifamily,59,55,4,0.0677966101694915
32.11,2025,Single Family - Detached,839,817,22,0.0262216924910608
32.11,2030,Mobile Home,0,0,0,
32.11,2030,Multifamily,62,59,3,0.0483870967741935
32.11,2030,Single Family - Detached,839,817,22,0.0262216924910608
32.11,2035,Mobile Home,0,0,0,
32.11,2035,Multifamily,63,60,3,0.0476190476190476
32.11,2035,Single Family - Detached,839,817,22,0.0262216924910608
32.11,2040,Mobile Home,0,0,0,
32.11,2040,Multifamily,63,59,4,0.0634920634920635
32.11,2040,Single Family - Detached,839,812,27,0.032181168057211
32.11,2045,Mobile Home,0,0,0,
32.11,2045,Multifamily,63,58,5,0.0793650793650794
32.11,2045,Single Family - Detached,839,806,33,0.0393325387365912
32.11,2050,Mobile Home,0,0,0,
32.11,2050,Multifamily,63,58,5,0.0793650793650794
32.11,2050,Single Family - Detached,839,806,33,0.0393325387365912
32.12,2012,Mobile Home,0,0,0,
32.12,2012,Multifamily,38,31,7,0.184210526315789
32.12,2012,Single Family - Detached,1063,1037,26,0.0244590780809031
32.12,2020,Mobile Home,0,0,0,
32.12,2020,Multifamily,38,32,6,0.157894736842105
32.12,2020,Single Family - Detached,1093,1045,48,0.0439158279963403
32.12,2025,Mobile Home,0,0,0,
32.12,2025,Multifamily,46,45,1,0.0217391304347826
32.12,2025,Single Family - Detached,1092,1051,41,0.0375457875457875
32.12,2030,Mobile Home,0,0,0,
32.12,2030,Multifamily,46,45,1,0.0217391304347826
32.12,2030,Single Family - Detached,1097,1051,46,0.0419325432999088
32.12,2035,Mobile Home,0,0,0,
32.12,2035,Multifamily,48,48,0,0
32.12,2035,Single Family - Detached,1103,1056,47,0.042611060743427
32.12,2040,Mobile Home,0,0,0,
32.12,2040,Multifamily,51,51,0,0
32.12,2040,Single Family - Detached,1103,1050,53,0.0480507706255666
32.12,2045,Mobile Home,0,0,0,
32.12,2045,Multifamily,51,51,0,0
32.12,2045,Single Family - Detached,1103,1044,59,0.0534904805077063
32.12,2050,Mobile Home,0,0,0,
32.12,2050,Multifamily,51,51,0,0
32.12,2050,Single Family - Detached,1103,1043,60,0.0543970988213962
32.13,2012,Mobile Home,0,0,0,
32.13,2012,Multifamily,0,0,0,
32.13,2012,Single Family - Detached,1081,1050,31,0.028677150786309
32.13,2020,Mobile Home,0,0,0,
32.13,2020,Multifamily,0,0,0,
32.13,2020,Single Family - Detached,1081,1035,46,0.0425531914893617
32.13,2025,Mobile Home,0,0,0,
32.13,2025,Multifamily,0,0,0,
32.13,2025,Single Family - Detached,1081,1042,39,0.0360777058279371
32.13,2030,Mobile Home,0,0,0,
32.13,2030,Multifamily,0,0,0,
32.13,2030,Single Family - Detached,1081,1040,41,0.0379278445883441
32.13,2035,Mobile Home,0,0,0,
32.13,2035,Multifamily,0,0,0,
32.13,2035,Single Family - Detached,1081,1039,42,0.0388529139685476
32.13,2040,Mobile Home,0,0,0,
32.13,2040,Multifamily,0,0,0,
32.13,2040,Single Family - Detached,1081,1033,48,0.0444033302497687
32.13,2045,Mobile Home,0,0,0,
32.13,2045,Multifamily,0,0,0,
32.13,2045,Single Family - Detached,1081,1024,57,0.0527289546716004
32.13,2050,Mobile Home,0,0,0,
32.13,2050,Multifamily,0,0,0,
32.13,2050,Single Family - Detached,1081,1022,59,0.0545790934320074
32.14,2012,Mobile Home,131,108,23,0.175572519083969
32.14,2012,Multifamily,383,409,-26,-0.0678851174934726
32.14,2012,Single Family - Detached,1054,926,128,0.121442125237192
32.14,2020,Mobile Home,131,109,22,0.16793893129771
32.14,2020,Multifamily,383,403,-20,-0.0522193211488251
32.14,2020,Single Family - Detached,1054,919,135,0.128083491461101
32.14,2025,Mobile Home,131,109,22,0.16793893129771
32.14,2025,Multifamily,383,402,-19,-0.0496083550913838
32.14,2025,Single Family - Detached,1146,1008,138,0.120418848167539
32.14,2030,Mobile Home,131,108,23,0.175572519083969
32.14,2030,Multifamily,383,402,-19,-0.0496083550913838
32.14,2030,Single Family - Detached,1180,1045,135,0.114406779661017
32.14,2035,Mobile Home,131,108,23,0.175572519083969
32.14,2035,Multifamily,383,402,-19,-0.0496083550913838
32.14,2035,Single Family - Detached,1184,1049,135,0.11402027027027
32.14,2040,Mobile Home,131,108,23,0.175572519083969
32.14,2040,Multifamily,383,402,-19,-0.0496083550913838
32.14,2040,Single Family - Detached,1489,1397,92,0.0617864338482203
32.14,2045,Mobile Home,131,107,24,0.183206106870229
32.14,2045,Multifamily,383,402,-19,-0.0496083550913838
32.14,2045,Single Family - Detached,1505,1408,97,0.0644518272425249
32.14,2050,Mobile Home,131,105,26,0.198473282442748
32.14,2050,Multifamily,383,400,-17,-0.0443864229765013
32.14,2050,Single Family - Detached,1505,1407,98,0.0651162790697674
33.01,2012,Mobile Home,0,0,0,
33.01,2012,Multifamily,289,286,3,0.0103806228373702
33.01,2012,Single Family - Detached,655,603,52,0.0793893129770992
33.01,2020,Mobile Home,0,0,0,
33.01,2020,Multifamily,289,285,4,0.013840830449827
33.01,2020,Single Family - Detached,655,597,58,0.0885496183206107
33.01,2025,Mobile Home,0,0,0,
33.01,2025,Multifamily,289,286,3,0.0103806228373702
33.01,2025,Single Family - Detached,657,606,51,0.0776255707762557
33.01,2030,Mobile Home,0,0,0,
33.01,2030,Multifamily,297,293,4,0.0134680134680135
33.01,2030,Single Family - Detached,673,627,46,0.0683506686478455
33.01,2035,Mobile Home,0,0,0,
33.01,2035,Multifamily,319,314,5,0.0156739811912226
33.01,2035,Single Family - Detached,688,643,45,0.0654069767441861
33.01,2040,Mobile Home,0,0,0,
33.01,2040,Multifamily,407,392,15,0.0368550368550369
33.01,2040,Single Family - Detached,687,635,52,0.0756914119359534
33.01,2045,Mobile Home,0,0,0,
33.01,2045,Multifamily,407,388,19,0.0466830466830467
33.01,2045,Single Family - Detached,687,627,60,0.0873362445414847
33.01,2050,Mobile Home,0,0,0,
33.01,2050,Multifamily,407,382,25,0.0614250614250614
33.01,2050,Single Family - Detached,687,622,65,0.0946142649199418
33.03,2012,Mobile Home,0,0,0,
33.03,2012,Multifamily,853,786,67,0.078546307151231
33.03,2012,Single Family - Detached,340,312,28,0.0823529411764706
33.03,2020,Mobile Home,0,0,0,
33.03,2020,Multifamily,853,786,67,0.078546307151231
33.03,2020,Single Family - Detached,340,304,36,0.105882352941176
33.03,2025,Mobile Home,0,0,0,
33.03,2025,Multifamily,853,786,67,0.078546307151231
33.03,2025,Single Family - Detached,340,313,27,0.0794117647058823
33.03,2030,Mobile Home,0,0,0,
33.03,2030,Multifamily,853,786,67,0.078546307151231
33.03,2030,Single Family - Detached,340,301,39,0.114705882352941
33.03,2035,Mobile Home,0,0,0,
33.03,2035,Multifamily,853,786,67,0.078546307151231
33.03,2035,Single Family - Detached,340,295,45,0.132352941176471
33.03,2040,Mobile Home,0,0,0,
33.03,2040,Multifamily,957,911,46,0.0480668756530825
33.03,2040,Single Family - Detached,331,284,47,0.141993957703928
33.03,2045,Mobile Home,0,0,0,
33.03,2045,Multifamily,977,936,41,0.0419651995905834
33.03,2045,Single Family - Detached,330,278,52,0.157575757575758
33.03,2050,Mobile Home,0,0,0,
33.03,2050,Multifamily,1333,1313,20,0.0150037509377344
33.03,2050,Single Family - Detached,227,201,26,0.114537444933921
33.04,2012,Mobile Home,265,239,26,0.0981132075471698
33.04,2012,Multifamily,636,588,48,0.0754716981132075
33.04,2012,Single Family - Detached,195,158,37,0.18974358974359
33.04,2020,Mobile Home,265,240,25,0.0943396226415094
33.04,2020,Multifamily,1000,949,51,0.051
33.04,2020,Single Family - Detached,195,152,43,0.220512820512821
33.04,2025,Mobile Home,265,240,25,0.0943396226415094
33.04,2025,Multifamily,1006,955,51,0.0506958250497018
33.04,2025,Single Family - Detached,195,157,38,0.194871794871795
33.04,2030,Mobile Home,211,190,21,0.0995260663507109
33.04,2030,Multifamily,1124,1073,51,0.045373665480427
33.04,2030,Single Family - Detached,245,221,24,0.0979591836734694
33.04,2035,Mobile Home,0,0,0,
33.04,2035,Multifamily,1432,1380,52,0.0363128491620112
33.04,2035,Single Family - Detached,258,234,24,0.0930232558139535
33.04,2040,Mobile Home,0,0,0,
33.04,2040,Multifamily,1712,1674,38,0.022196261682243
33.04,2040,Single Family - Detached,200,193,7,0.035
33.04,2045,Mobile Home,0,0,0,
33.04,2045,Multifamily,1712,1673,39,0.0227803738317757
33.04,2045,Single Family - Detached,200,189,11,0.055
33.04,2050,Mobile Home,0,0,0,
33.04,2050,Multifamily,1712,1669,43,0.0251168224299065
33.04,2050,Single Family - Detached,200,186,14,0.07
33.05,2012,Mobile Home,0,0,0,
33.05,2012,Multifamily,876,854,22,0.0251141552511416
33.05,2012,Single Family - Detached,716,667,49,0.0684357541899441
33.05,2020,Mobile Home,0,0,0,
33.05,2020,Multifamily,1021,991,30,0.029382957884427
33.05,2020,Single Family - Detached,716,661,55,0.0768156424581006
33.05,2025,Mobile Home,0,0,0,
33.05,2025,Multifamily,1021,993,28,0.0274240940254652
33.05,2025,Single Family - Detached,716,668,48,0.0670391061452514
33.05,2030,Mobile Home,0,0,0,
33.05,2030,Multifamily,1021,992,29,0.0284035259549461
33.05,2030,Single Family - Detached,717,659,58,0.0808926080892608
33.05,2035,Mobile Home,0,0,0,
33.05,2035,Multifamily,1021,992,29,0.0284035259549461
33.05,2035,Single Family - Detached,778,737,41,0.0526992287917738
33.05,2040,Mobile Home,0,0,0,
33.05,2040,Multifamily,1153,1126,27,0.023417172593235
33.05,2040,Single Family - Detached,760,720,40,0.0526315789473684
33.05,2045,Mobile Home,0,0,0,
33.05,2045,Multifamily,1157,1138,19,0.0164217804667243
33.05,2045,Single Family - Detached,843,794,49,0.0581257413997628
33.05,2050,Mobile Home,0,0,0,
33.05,2050,Multifamily,1221,1196,25,0.0204750204750205
33.05,2050,Single Family - Detached,842,787,55,0.0653206650831354
34.01,2012,Mobile Home,189,189,0,0
34.01,2012,Multifamily,663,662,1,0.00150829562594268
34.01,2012,Single Family - Detached,1233,1156,77,0.0624493106244931
34.01,2020,Mobile Home,171,171,0,0
34.01,2020,Multifamily,688,682,6,0.00872093023255814
34.01,2020,Single Family - Detached,1233,1154,79,0.0640713706407137
34.01,2025,Mobile Home,69,69,0,0
34.01,2025,Multifamily,811,807,4,0.00493218249075216
34.01,2025,Single Family - Detached,1253,1221,32,0.0255387071029529
34.01,2030,Mobile Home,0,0,0,
34.01,2030,Multifamily,1211,1202,9,0.0074318744838976
34.01,2030,Single Family - Detached,1265,1232,33,0.0260869565217391
34.01,2035,Mobile Home,0,0,0,
34.01,2035,Multifamily,1211,1200,11,0.00908340214698596
34.01,2035,Single Family - Detached,1265,1234,31,0.0245059288537549
34.01,2040,Mobile Home,0,0,0,
34.01,2040,Multifamily,1213,1195,18,0.0148392415498763
34.01,2040,Single Family - Detached,1285,1252,33,0.0256809338521401
34.01,2045,Mobile Home,0,0,0,
34.01,2045,Multifamily,1215,1188,27,0.0222222222222222
34.01,2045,Single Family - Detached,1285,1251,34,0.0264591439688716
34.01,2050,Mobile Home,0,0,0,
34.01,2050,Multifamily,1379,1336,43,0.0311820159535896
34.01,2050,Single Family - Detached,1284,1248,36,0.0280373831775701
34.03,2012,Mobile Home,0,0,0,
34.03,2012,Multifamily,83,78,5,0.0602409638554217
34.03,2012,Single Family - Detached,1005,971,34,0.0338308457711443
34.03,2020,Mobile Home,0,0,0,
34.03,2020,Multifamily,84,79,5,0.0595238095238095
34.03,2020,Single Family - Detached,1056,1027,29,0.0274621212121212
34.03,2025,Mobile Home,0,0,0,
34.03,2025,Multifamily,90,85,5,0.0555555555555556
34.03,2025,Single Family - Detached,1081,1061,20,0.0185013876040703
34.03,2030,Mobile Home,0,0,0,
34.03,2030,Multifamily,125,116,9,0.072
34.03,2030,Single Family - Detached,1084,1058,26,0.0239852398523985
34.03,2035,Mobile Home,0,0,0,
34.03,2035,Multifamily,125,115,10,0.08
34.03,2035,Single Family - Detached,1084,1058,26,0.0239852398523985
34.03,2040,Mobile Home,0,0,0,
34.03,2040,Multifamily,125,110,15,0.12
34.03,2040,Single Family - Detached,1084,1057,27,0.0249077490774908
34.03,2045,Mobile Home,0,0,0,
34.03,2045,Multifamily,125,107,18,0.144
34.03,2045,Single Family - Detached,1084,1054,30,0.0276752767527675
34.03,2050,Mobile Home,0,0,0,
34.03,2050,Multifamily,125,102,23,0.184
34.03,2050,Single Family - Detached,1084,1053,31,0.0285977859778598
34.04,2012,Mobile Home,0,0,0,
34.04,2012,Multifamily,205,203,2,0.00975609756097561
34.04,2012,Single Family - Detached,938,873,65,0.0692963752665245
34.04,2020,Mobile Home,0,0,0,
34.04,2020,Multifamily,577,553,24,0.0415944540727903
34.04,2020,Single Family - Detached,1040,971,69,0.0663461538461538
34.04,2025,Mobile Home,0,0,0,
34.04,2025,Multifamily,720,695,25,0.0347222222222222
34.04,2025,Single Family - Detached,1000,934,66,0.066
34.04,2030,Mobile Home,0,0,0,
34.04,2030,Multifamily,1219,1183,36,0.029532403609516
34.04,2030,Single Family - Detached,847,837,10,0.0118063754427391
34.04,2035,Mobile Home,0,0,0,
34.04,2035,Multifamily,1307,1272,35,0.026778882938026
34.04,2035,Single Family - Detached,847,832,15,0.0177095631641086
34.04,2040,Mobile Home,0,0,0,
34.04,2040,Multifamily,1307,1253,54,0.0413159908186687
34.04,2040,Single Family - Detached,847,828,19,0.0224321133412042
34.04,2045,Mobile Home,0,0,0,
34.04,2045,Multifamily,1307,1248,59,0.045141545524101
34.04,2045,Single Family - Detached,847,821,26,0.0306965761511216
34.04,2050,Mobile Home,0,0,0,
34.04,2050,Multifamily,1307,1240,67,0.0512624330527927
34.04,2050,Single Family - Detached,847,819,28,0.0330578512396694
35.01,2012,Mobile Home,0,0,0,
35.01,2012,Multifamily,245,228,17,0.0693877551020408
35.01,2012,Single Family - Detached,854,801,53,0.0620608899297424
35.01,2020,Mobile Home,0,0,0,
35.01,2020,Multifamily,245,226,19,0.0775510204081633
35.01,2020,Single Family - Detached,849,794,55,0.0647820965842167
35.01,2025,Mobile Home,0,0,0,
35.01,2025,Multifamily,245,230,15,0.0612244897959184
35.01,2025,Single Family - Detached,867,838,29,0.0334486735870819
35.01,2030,Mobile Home,0,0,0,
35.01,2030,Multifamily,277,267,10,0.036101083032491
35.01,2030,Single Family - Detached,878,851,27,0.030751708428246
35.01,2035,Mobile Home,0,0,0,
35.01,2035,Multifamily,277,267,10,0.036101083032491
35.01,2035,Single Family - Detached,878,851,27,0.030751708428246
35.01,2040,Mobile Home,0,0,0,
35.01,2040,Multifamily,294,274,20,0.0680272108843537
35.01,2040,Single Family - Detached,878,848,30,0.0341685649202733
35.01,2045,Mobile Home,0,0,0,
35.01,2045,Multifamily,294,267,27,0.0918367346938776
35.01,2045,Single Family - Detached,878,841,37,0.0421412300683371
35.01,2050,Mobile Home,0,0,0,
35.01,2050,Multifamily,294,258,36,0.122448979591837
35.01,2050,Single Family - Detached,878,839,39,0.0444191343963554
35.02,2012,Mobile Home,0,0,0,
35.02,2012,Multifamily,257,245,12,0.0466926070038911
35.02,2012,Single Family - Detached,987,956,31,0.0314083080040527
35.02,2020,Mobile Home,0,0,0,
35.02,2020,Multifamily,257,240,17,0.066147859922179
35.02,2020,Single Family - Detached,987,954,33,0.033434650455927
35.02,2025,Mobile Home,0,0,0,
35.02,2025,Multifamily,257,245,12,0.0466926070038911
35.02,2025,Single Family - Detached,987,958,29,0.0293819655521783
35.02,2030,Mobile Home,0,0,0,
35.02,2030,Multifamily,257,238,19,0.0739299610894942
35.02,2030,Single Family - Detached,1065,1026,39,0.0366197183098592
35.02,2035,Mobile Home,0,0,0,
35.02,2035,Multifamily,257,238,19,0.0739299610894942
35.02,2035,Single Family - Detached,1214,1196,18,0.014827018121911
35.02,2040,Mobile Home,0,0,0,
35.02,2040,Multifamily,473,433,40,0.0845665961945032
35.02,2040,Single Family - Detached,1129,1114,15,0.0132860938883968
35.02,2045,Mobile Home,0,0,0,
35.02,2045,Multifamily,498,462,36,0.072289156626506
35.02,2045,Single Family - Detached,1129,1109,20,0.0177147918511957
35.02,2050,Mobile Home,0,0,0,
35.02,2050,Multifamily,507,456,51,0.100591715976331
35.02,2050,Single Family - Detached,1129,1106,23,0.0203720106288751
36.01,2012,Mobile Home,0,0,0,
36.01,2012,Multifamily,143,139,4,0.027972027972028
36.01,2012,Single Family - Detached,640,612,28,0.04375
36.01,2020,Mobile Home,0,0,0,
36.01,2020,Multifamily,139,132,7,0.0503597122302158
36.01,2020,Single Family - Detached,640,611,29,0.0453125
36.01,2025,Mobile Home,0,0,0,
36.01,2025,Multifamily,139,133,6,0.0431654676258993
36.01,2025,Single Family - Detached,640,612,28,0.04375
36.01,2030,Mobile Home,0,0,0,
36.01,2030,Multifamily,139,126,13,0.0935251798561151
36.01,2030,Single Family - Detached,640,601,39,0.0609375
36.01,2035,Mobile Home,0,0,0,
36.01,2035,Multifamily,139,124,15,0.107913669064748
36.01,2035,Single Family - Detached,640,602,38,0.059375
36.01,2040,Mobile Home,0,0,0,
36.01,2040,Multifamily,139,111,28,0.201438848920863
36.01,2040,Single Family - Detached,640,601,39,0.0609375
36.01,2045,Mobile Home,0,0,0,
36.01,2045,Multifamily,195,157,38,0.194871794871795
36.01,2045,Single Family - Detached,656,616,40,0.0609756097560976
36.01,2050,Mobile Home,0,0,0,
36.01,2050,Multifamily,252,205,47,0.186507936507937
36.01,2050,Single Family - Detached,653,612,41,0.0627871362940276
36.02,2012,Mobile Home,0,0,0,
36.02,2012,Multifamily,160,149,11,0.06875
36.02,2012,Single Family - Detached,571,548,23,0.0402802101576182
36.02,2020,Mobile Home,0,0,0,
36.02,2020,Multifamily,160,146,14,0.0875
36.02,2020,Single Family - Detached,571,537,34,0.0595446584938704
36.02,2025,Mobile Home,0,0,0,
36.02,2025,Multifamily,160,151,9,0.05625
36.02,2025,Single Family - Detached,571,547,24,0.042031523642732
36.02,2030,Mobile Home,0,0,0,
36.02,2030,Multifamily,160,146,14,0.0875
36.02,2030,Single Family - Detached,571,531,40,0.0700525394045534
36.02,2035,Mobile Home,0,0,0,
36.02,2035,Multifamily,160,146,14,0.0875
36.02,2035,Single Family - Detached,577,533,44,0.0762564991334489
36.02,2040,Mobile Home,0,0,0,
36.02,2040,Multifamily,242,220,22,0.0909090909090909
36.02,2040,Single Family - Detached,553,498,55,0.0994575045207957
36.02,2045,Mobile Home,0,0,0,
36.02,2045,Multifamily,293,265,28,0.0955631399317406
36.02,2045,Single Family - Detached,579,539,40,0.0690846286701209
36.02,2050,Mobile Home,0,0,0,
36.02,2050,Multifamily,427,400,27,0.063231850117096
36.02,2050,Single Family - Detached,549,505,44,0.0801457194899818
36.03,2012,Mobile Home,0,0,0,
36.03,2012,Multifamily,165,153,12,0.0727272727272727
36.03,2012,Single Family - Detached,899,858,41,0.0456062291434928
36.03,2020,Mobile Home,0,0,0,
36.03,2020,Multifamily,165,146,19,0.115151515151515
36.03,2020,Single Family - Detached,899,849,50,0.0556173526140156
36.03,2025,Mobile Home,0,0,0,
36.03,2025,Multifamily,165,153,12,0.0727272727272727
36.03,2025,Single Family - Detached,899,862,37,0.0411568409343715
36.03,2030,Mobile Home,0,0,0,
36.03,2030,Multifamily,165,146,19,0.115151515151515
36.03,2030,Single Family - Detached,899,840,59,0.0656284760845384
36.03,2035,Mobile Home,0,0,0,
36.03,2035,Multifamily,165,146,19,0.115151515151515
36.03,2035,Single Family - Detached,899,835,64,0.0711902113459399
36.03,2040,Mobile Home,0,0,0,
36.03,2040,Multifamily,165,127,38,0.23030303030303
36.03,2040,Single Family - Detached,899,822,77,0.085650723025584
36.03,2045,Mobile Home,0,0,0,
36.03,2045,Multifamily,165,115,50,0.303030303030303
36.03,2045,Single Family - Detached,899,808,91,0.101223581757508
36.03,2050,Mobile Home,0,0,0,
36.03,2050,Multifamily,206,148,58,0.281553398058252
36.03,2050,Single Family - Detached,898,802,96,0.106904231625835
38,2012,Mobile Home,0,0,0,
38,2012,Multifamily,0,0,0,
38,2012,Single Family - Detached,0,0,0,
38,2020,Mobile Home,0,0,0,
38,2020,Multifamily,0,0,0,
38,2020,Single Family - Detached,0,0,0,
38,2025,Mobile Home,0,0,0,
38,2025,Multifamily,0,0,0,
38,2025,Single Family - Detached,0,0,0,
38,2030,Mobile Home,0,0,0,
38,2030,Multifamily,0,0,0,
38,2030,Single Family - Detached,0,0,0,
38,2035,Mobile Home,0,0,0,
38,2035,Multifamily,0,0,0,
38,2035,Single Family - Detached,0,0,0,
38,2040,Mobile Home,0,0,0,
38,2040,Multifamily,0,0,0,
38,2040,Single Family - Detached,0,0,0,
38,2045,Mobile Home,0,0,0,
38,2045,Multifamily,0,0,0,
38,2045,Single Family - Detached,0,0,0,
38,2050,Mobile Home,0,0,0,
38,2050,Multifamily,0,0,0,
38,2050,Single Family - Detached,0,0,0,
39.01,2012,Mobile Home,0,0,0,
39.01,2012,Multifamily,214,202,12,0.0560747663551402
39.01,2012,Single Family - Detached,821,776,45,0.0548112058465286
39.01,2020,Mobile Home,0,0,0,
39.01,2020,Multifamily,214,200,14,0.0654205607476635
39.01,2020,Single Family - Detached,821,776,45,0.0548112058465286
39.01,2025,Mobile Home,0,0,0,
39.01,2025,Multifamily,214,197,17,0.0794392523364486
39.01,2025,Single Family - Detached,821,788,33,0.0401948842874543
39.01,2030,Mobile Home,0,0,0,
39.01,2030,Multifamily,283,250,33,0.11660777385159
39.01,2030,Single Family - Detached,827,810,17,0.0205562273276904
39.01,2035,Mobile Home,0,0,0,
39.01,2035,Multifamily,291,259,32,0.109965635738832
39.01,2035,Single Family - Detached,825,810,15,0.0181818181818182
39.01,2040,Mobile Home,0,0,0,
39.01,2040,Multifamily,309,270,39,0.12621359223301
39.01,2040,Single Family - Detached,829,808,21,0.0253317249698432
39.01,2045,Mobile Home,0,0,0,
39.01,2045,Multifamily,401,353,48,0.119700748129676
39.01,2045,Single Family - Detached,807,781,26,0.0322180916976456
39.01,2050,Mobile Home,0,0,0,
39.01,2050,Multifamily,415,371,44,0.106024096385542
39.01,2050,Single Family - Detached,807,780,27,0.033457249070632
39.02,2012,Mobile Home,0,0,0,
39.02,2012,Multifamily,397,391,6,0.0151133501259446
39.02,2012,Single Family - Detached,857,856,1,0.00116686114352392
39.02,2020,Mobile Home,0,0,0,
39.02,2020,Multifamily,397,386,11,0.0277078085642317
39.02,2020,Single Family - Detached,851,850,1,0.00117508813160987
39.02,2025,Mobile Home,0,0,0,
39.02,2025,Multifamily,397,381,16,0.0403022670025189
39.02,2025,Single Family - Detached,851,851,0,0
39.02,2030,Mobile Home,0,0,0,
39.02,2030,Multifamily,397,365,32,0.0806045340050378
39.02,2030,Single Family - Detached,851,840,11,0.0129259694477086
39.02,2035,Mobile Home,0,0,0,
39.02,2035,Multifamily,399,369,30,0.075187969924812
39.02,2035,Single Family - Detached,844,834,10,0.0118483412322275
39.02,2040,Mobile Home,0,0,0,
39.02,2040,Multifamily,406,373,33,0.0812807881773399
39.02,2040,Single Family - Detached,834,823,11,0.013189448441247
39.02,2045,Mobile Home,0,0,0,
39.02,2045,Multifamily,426,377,49,0.115023474178404
39.02,2045,Single Family - Detached,841,832,9,0.0107015457788347
39.02,2050,Mobile Home,0,0,0,
39.02,2050,Multifamily,445,386,59,0.132584269662921
39.02,2050,Single Family - Detached,838,828,10,0.0119331742243437
4,2012,Mobile Home,0,0,0,
4,2012,Multifamily,2058,1931,127,0.0617103984450923
4,2012,Single Family - Detached,245,220,25,0.102040816326531
4,2020,Mobile Home,0,0,0,
4,2020,Multifamily,2024,1937,87,0.0429841897233202
4,2020,Single Family - Detached,221,180,41,0.18552036199095
4,2025,Mobile Home,0,0,0,
4,2025,Multifamily,2529,2414,115,0.0454725187821273
4,2025,Single Family - Detached,183,159,24,0.131147540983607
4,2030,Mobile Home,0,0,0,
4,2030,Multifamily,2555,2420,135,0.0528375733855186
4,2030,Single Family - Detached,175,148,27,0.154285714285714
4,2035,Mobile Home,0,0,0,
4,2035,Multifamily,2724,2583,141,0.0517621145374449
4,2035,Single Family - Detached,166,142,24,0.144578313253012
4,2040,Mobile Home,0,0,0,
4,2040,Multifamily,3500,3370,130,0.0371428571428571
4,2040,Single Family - Detached,97,90,7,0.0721649484536082
4,2045,Mobile Home,0,0,0,
4,2045,Multifamily,3974,3826,148,0.0372420734776044
4,2045,Single Family - Detached,58,48,10,0.172413793103448
4,2050,Mobile Home,0,0,0,
4,2050,Multifamily,4199,4006,193,0.0459633246010955
4,2050,Single Family - Detached,48,34,14,0.291666666666667
40,2012,Mobile Home,0,0,0,
40,2012,Multifamily,237,233,4,0.0168776371308017
40,2012,Single Family - Detached,961,961,0,0
40,2020,Mobile Home,0,0,0,
40,2020,Multifamily,237,233,4,0.0168776371308017
40,2020,Single Family - Detached,968,966,2,0.00206611570247934
40,2025,Mobile Home,0,0,0,
40,2025,Multifamily,392,376,16,0.0408163265306122
40,2025,Single Family - Detached,925,925,0,0
40,2030,Mobile Home,0,0,0,
40,2030,Multifamily,522,502,20,0.0383141762452107
40,2030,Single Family - Detached,879,863,16,0.0182025028441411
40,2035,Mobile Home,0,0,0,
40,2035,Multifamily,709,678,31,0.0437235543018336
40,2035,Single Family - Detached,842,829,13,0.0154394299287411
40,2040,Mobile Home,0,0,0,
40,2040,Multifamily,786,742,44,0.0559796437659033
40,2040,Single Family - Detached,819,798,21,0.0256410256410256
40,2045,Mobile Home,0,0,0,
40,2045,Multifamily,788,737,51,0.0647208121827411
40,2045,Single Family - Detached,819,787,32,0.0390720390720391
40,2050,Mobile Home,0,0,0,
40,2050,Multifamily,788,728,60,0.0761421319796954
40,2050,Single Family - Detached,819,787,32,0.0390720390720391
41,2012,Mobile Home,0,0,0,
41,2012,Multifamily,1648,1564,84,0.0509708737864078
41,2012,Single Family - Detached,1093,1037,56,0.0512351326623971
41,2020,Mobile Home,0,0,0,
41,2020,Multifamily,1709,1621,88,0.0514921006436513
41,2020,Single Family - Detached,1143,1088,55,0.0481189851268591
41,2025,Mobile Home,0,0,0,
41,2025,Multifamily,1889,1804,85,0.0449973530968767
41,2025,Single Family - Detached,1075,1026,49,0.0455813953488372
41,2030,Mobile Home,0,0,0,
41,2030,Multifamily,2353,2260,93,0.0395240118997025
41,2030,Single Family - Detached,1013,959,54,0.0533070088845015
41,2035,Mobile Home,0,0,0,
41,2035,Multifamily,2819,2728,91,0.0322809506917347
41,2035,Single Family - Detached,905,858,47,0.0519337016574586
41,2040,Mobile Home,0,0,0,
41,2040,Multifamily,3084,2996,88,0.0285343709468223
41,2040,Single Family - Detached,909,864,45,0.0495049504950495
41,2045,Mobile Home,0,0,0,
41,2045,Multifamily,3183,3113,70,0.0219918316054037
41,2045,Single Family - Detached,888,834,54,0.0608108108108108
41,2050,Mobile Home,0,0,0,
41,2050,Multifamily,3277,3215,62,0.018919743667989
41,2050,Single Family - Detached,869,814,55,0.0632911392405063
42,2012,Mobile Home,0,0,0,
42,2012,Multifamily,197,196,1,0.0050761421319797
42,2012,Single Family - Detached,2303,2247,56,0.0243161094224924
42,2020,Mobile Home,0,0,0,
42,2020,Multifamily,210,209,1,0.00476190476190476
42,2020,Single Family - Detached,2309,2245,64,0.0277176266782157
42,2025,Mobile Home,0,0,0,
42,2025,Multifamily,329,324,5,0.0151975683890578
42,2025,Single Family - Detached,2309,2256,53,0.0229536595928974
42,2030,Mobile Home,0,0,0,
42,2030,Multifamily,454,449,5,0.0110132158590308
42,2030,Single Family - Detached,2305,2252,53,0.0229934924078091
42,2035,Mobile Home,0,0,0,
42,2035,Multifamily,454,450,4,0.00881057268722467
42,2035,Single Family - Detached,2305,2252,53,0.0229934924078091
42,2040,Mobile Home,0,0,0,
42,2040,Multifamily,463,453,10,0.0215982721382289
42,2040,Single Family - Detached,2337,2277,60,0.0256739409499358
42,2045,Mobile Home,0,0,0,
42,2045,Multifamily,463,452,11,0.0237580993520518
42,2045,Single Family - Detached,2354,2292,62,0.0263381478334749
42,2050,Mobile Home,0,0,0,
42,2050,Multifamily,463,452,11,0.0237580993520518
42,2050,Single Family - Detached,2354,2292,62,0.0263381478334749
43,2012,Mobile Home,0,0,0,
43,2012,Multifamily,589,553,36,0.0611205432937182
43,2012,Single Family - Detached,1262,1236,26,0.0206022187004754
43,2020,Mobile Home,0,0,0,
43,2020,Multifamily,589,556,33,0.0560271646859083
43,2020,Single Family - Detached,1259,1233,26,0.0206513105639396
43,2025,Mobile Home,0,0,0,
43,2025,Multifamily,628,599,29,0.0461783439490446
43,2025,Single Family - Detached,1258,1241,17,0.0135135135135135
43,2030,Mobile Home,0,0,0,
43,2030,Multifamily,651,622,29,0.0445468509984639
43,2030,Single Family - Detached,1254,1237,17,0.0135566188197767
43,2035,Mobile Home,0,0,0,
43,2035,Multifamily,651,622,29,0.0445468509984639
43,2035,Single Family - Detached,1254,1237,17,0.0135566188197767
43,2040,Mobile Home,0,0,0,
43,2040,Multifamily,693,671,22,0.0317460317460317
43,2040,Single Family - Detached,1257,1236,21,0.0167064439140811
43,2045,Mobile Home,0,0,0,
43,2045,Multifamily,693,671,22,0.0317460317460317
43,2045,Single Family - Detached,1258,1232,26,0.0206677265500795
43,2050,Mobile Home,0,0,0,
43,2050,Multifamily,693,671,22,0.0317460317460317
43,2050,Single Family - Detached,1258,1232,26,0.0206677265500795
44,2012,Mobile Home,0,0,0,
44,2012,Multifamily,399,388,11,0.0275689223057644
44,2012,Single Family - Detached,1443,1405,38,0.0263340263340263
44,2020,Mobile Home,0,0,0,
44,2020,Multifamily,546,529,17,0.0311355311355311
44,2020,Single Family - Detached,1483,1445,38,0.0256237356709373
44,2025,Mobile Home,0,0,0,
44,2025,Multifamily,576,570,6,0.0104166666666667
44,2025,Single Family - Detached,1477,1452,25,0.016926201760325
44,2030,Mobile Home,0,0,0,
44,2030,Multifamily,576,549,27,0.046875
44,2030,Single Family - Detached,1472,1442,30,0.0203804347826087
44,2035,Mobile Home,0,0,0,
44,2035,Multifamily,576,539,37,0.0642361111111111
44,2035,Single Family - Detached,1469,1445,24,0.0163376446562287
44,2040,Mobile Home,0,0,0,
44,2040,Multifamily,599,536,63,0.105175292153589
44,2040,Single Family - Detached,1470,1443,27,0.0183673469387755
44,2045,Mobile Home,0,0,0,
44,2045,Multifamily,599,518,81,0.135225375626043
44,2045,Single Family - Detached,1471,1440,31,0.0210740992522094
44,2050,Mobile Home,0,0,0,
44,2050,Multifamily,599,504,95,0.158597662771285
44,2050,Single Family - Detached,1471,1439,32,0.0217539089055065
45.01,2012,Mobile Home,0,0,0,
45.01,2012,Multifamily,1025,993,32,0.031219512195122
45.01,2012,Single Family - Detached,408,393,15,0.0367647058823529
45.01,2020,Mobile Home,0,0,0,
45.01,2020,Multifamily,1025,993,32,0.031219512195122
45.01,2020,Single Family - Detached,408,392,16,0.0392156862745098
45.01,2025,Mobile Home,0,0,0,
45.01,2025,Multifamily,1025,993,32,0.031219512195122
45.01,2025,Single Family - Detached,408,393,15,0.0367647058823529
45.01,2030,Mobile Home,0,0,0,
45.01,2030,Multifamily,1231,1213,18,0.0146222583265638
45.01,2030,Single Family - Detached,344,334,10,0.0290697674418605
45.01,2035,Mobile Home,0,0,0,
45.01,2035,Multifamily,1365,1347,18,0.0131868131868132
45.01,2035,Single Family - Detached,302,293,9,0.0298013245033113
45.01,2040,Mobile Home,0,0,0,
45.01,2040,Multifamily,1368,1350,18,0.0131578947368421
45.01,2040,Single Family - Detached,316,305,11,0.0348101265822785
45.01,2045,Mobile Home,0,0,0,
45.01,2045,Multifamily,1368,1350,18,0.0131578947368421
45.01,2045,Single Family - Detached,316,304,12,0.0379746835443038
45.01,2050,Mobile Home,0,0,0,
45.01,2050,Multifamily,1368,1350,18,0.0131578947368421
45.01,2050,Single Family - Detached,319,306,13,0.0407523510971787
46,2012,Mobile Home,0,0,0,
46,2012,Multifamily,733,673,60,0.0818553888130969
46,2012,Single Family - Detached,414,375,39,0.0942028985507246
46,2020,Mobile Home,0,0,0,
46,2020,Multifamily,742,683,59,0.0795148247978437
46,2020,Single Family - Detached,414,361,53,0.128019323671498
46,2025,Mobile Home,0,0,0,
46,2025,Multifamily,744,699,45,0.0604838709677419
46,2025,Single Family - Detached,414,375,39,0.0942028985507246
46,2030,Mobile Home,0,0,0,
46,2030,Multifamily,744,682,62,0.0833333333333333
46,2030,Single Family - Detached,415,374,41,0.0987951807228916
46,2035,Mobile Home,0,0,0,
46,2035,Multifamily,749,685,64,0.0854472630173565
46,2035,Single Family - Detached,415,378,37,0.0891566265060241
46,2040,Mobile Home,0,0,0,
46,2040,Multifamily,776,696,80,0.103092783505155
46,2040,Single Family - Detached,415,369,46,0.110843373493976
46,2045,Mobile Home,0,0,0,
46,2045,Multifamily,776,677,99,0.127577319587629
46,2045,Single Family - Detached,415,366,49,0.118072289156627
46,2050,Mobile Home,0,0,0,
46,2050,Multifamily,776,669,107,0.137886597938144
46,2050,Single Family - Detached,415,365,50,0.120481927710843
47,2012,Mobile Home,0,0,0,
47,2012,Multifamily,385,321,64,0.166233766233766
47,2012,Single Family - Detached,375,313,62,0.165333333333333
47,2020,Mobile Home,0,0,0,
47,2020,Multifamily,385,321,64,0.166233766233766
47,2020,Single Family - Detached,375,313,62,0.165333333333333
47,2025,Mobile Home,0,0,0,
47,2025,Multifamily,386,324,62,0.160621761658031
47,2025,Single Family - Detached,375,323,52,0.138666666666667
47,2030,Mobile Home,0,0,0,
47,2030,Multifamily,392,347,45,0.114795918367347
47,2030,Single Family - Detached,385,337,48,0.124675324675325
47,2035,Mobile Home,0,0,0,
47,2035,Multifamily,392,348,44,0.112244897959184
47,2035,Single Family - Detached,385,337,48,0.124675324675325
47,2040,Mobile Home,0,0,0,
47,2040,Multifamily,460,411,49,0.106521739130435
47,2040,Single Family - Detached,363,316,47,0.129476584022039
47,2045,Mobile Home,0,0,0,
47,2045,Multifamily,515,462,53,0.102912621359223
47,2045,Single Family - Detached,352,300,52,0.147727272727273
47,2050,Mobile Home,0,0,0,
47,2050,Multifamily,515,461,54,0.104854368932039
47,2050,Single Family - Detached,352,299,53,0.150568181818182
48,2012,Mobile Home,0,0,0,
48,2012,Multifamily,354,300,54,0.152542372881356
48,2012,Single Family - Detached,854,795,59,0.0690866510538642
48,2020,Mobile Home,0,0,0,
48,2020,Multifamily,354,300,54,0.152542372881356
48,2020,Single Family - Detached,854,795,59,0.0690866510538642
48,2025,Mobile Home,0,0,0,
48,2025,Multifamily,356,307,49,0.137640449438202
48,2025,Single Family - Detached,854,807,47,0.0550351288056206
48,2030,Mobile Home,0,0,0,
48,2030,Multifamily,380,320,60,0.157894736842105
48,2030,Single Family - Detached,858,823,35,0.0407925407925408
48,2035,Mobile Home,0,0,0,
48,2035,Multifamily,422,363,59,0.139810426540284
48,2035,Single Family - Detached,795,768,27,0.0339622641509434
48,2040,Mobile Home,0,0,0,
48,2040,Multifamily,605,547,58,0.0958677685950413
48,2040,Single Family - Detached,764,741,23,0.0301047120418848
48,2045,Mobile Home,0,0,0,
48,2045,Multifamily,641,582,59,0.0920436817472699
48,2045,Single Family - Detached,754,730,24,0.0318302387267905
48,2050,Mobile Home,0,0,0,
48,2050,Multifamily,641,578,63,0.0982839313572543
48,2050,Single Family - Detached,754,729,25,0.0331564986737401
49,2012,Mobile Home,0,0,0,
49,2012,Multifamily,211,203,8,0.037914691943128
49,2012,Single Family - Detached,1158,1146,12,0.0103626943005181
49,2020,Mobile Home,0,0,0,
49,2020,Multifamily,477,443,34,0.0712788259958071
49,2020,Single Family - Detached,1158,1146,12,0.0103626943005181
49,2025,Mobile Home,0,0,0,
49,2025,Multifamily,477,443,34,0.0712788259958071
49,2025,Single Family - Detached,1158,1147,11,0.00949913644214162
49,2030,Mobile Home,0,0,0,
49,2030,Multifamily,477,439,38,0.079664570230608
49,2030,Single Family - Detached,1165,1153,12,0.0103004291845494
49,2035,Mobile Home,0,0,0,
49,2035,Multifamily,477,439,38,0.079664570230608
49,2035,Single Family - Detached,1165,1153,12,0.0103004291845494
49,2040,Mobile Home,0,0,0,
49,2040,Multifamily,481,434,47,0.0977130977130977
49,2040,Single Family - Detached,1190,1177,13,0.0109243697478992
49,2045,Mobile Home,0,0,0,
49,2045,Multifamily,481,430,51,0.106029106029106
49,2045,Single Family - Detached,1289,1280,9,0.00698215671062839
49,2050,Mobile Home,0,0,0,
49,2050,Multifamily,494,444,50,0.101214574898785
49,2050,Single Family - Detached,1297,1288,9,0.00693909020817271
5,2012,Mobile Home,0,0,0,
5,2012,Multifamily,909,886,23,0.0253025302530253
5,2012,Single Family - Detached,797,749,48,0.0602258469259724
5,2020,Mobile Home,0,0,0,
5,2020,Multifamily,1177,1149,28,0.0237892948173322
5,2020,Single Family - Detached,724,688,36,0.0497237569060773
5,2025,Mobile Home,0,0,0,
5,2025,Multifamily,1264,1223,41,0.0324367088607595
5,2025,Single Family - Detached,715,681,34,0.0475524475524476
5,2030,Mobile Home,0,0,0,
5,2030,Multifamily,1264,1210,54,0.0427215189873418
5,2030,Single Family - Detached,715,681,34,0.0475524475524476
5,2035,Mobile Home,0,0,0,
5,2035,Multifamily,1264,1208,56,0.0443037974683544
5,2035,Single Family - Detached,715,681,34,0.0475524475524476
5,2040,Mobile Home,0,0,0,
5,2040,Multifamily,1264,1183,81,0.0640822784810127
5,2040,Single Family - Detached,715,680,35,0.048951048951049
5,2045,Mobile Home,0,0,0,
5,2045,Multifamily,1264,1159,105,0.0830696202531646
5,2045,Single Family - Detached,715,679,36,0.0503496503496504
5,2050,Mobile Home,0,0,0,
5,2050,Multifamily,1264,1136,128,0.10126582278481
5,2050,Single Family - Detached,715,677,38,0.0531468531468531
50,2012,Mobile Home,0,0,0,
50,2012,Multifamily,354,298,56,0.15819209039548
50,2012,Single Family - Detached,285,272,13,0.0456140350877193
50,2020,Mobile Home,0,0,0,
50,2020,Multifamily,606,501,105,0.173267326732673
50,2020,Single Family - Detached,254,246,8,0.031496062992126
50,2025,Mobile Home,0,0,0,
50,2025,Multifamily,606,489,117,0.193069306930693
50,2025,Single Family - Detached,240,232,8,0.0333333333333333
50,2030,Mobile Home,0,0,0,
50,2030,Multifamily,976,805,171,0.175204918032787
50,2030,Single Family - Detached,227,221,6,0.026431718061674
50,2035,Mobile Home,0,0,0,
50,2035,Multifamily,1387,1187,200,0.144196106705119
50,2035,Single Family - Detached,205,200,5,0.024390243902439
50,2040,Mobile Home,0,0,0,
50,2040,Multifamily,1701,1464,237,0.139329805996473
50,2040,Single Family - Detached,167,160,7,0.0419161676646707
50,2045,Mobile Home,0,0,0,
50,2045,Multifamily,2241,1958,283,0.12628290941544
50,2045,Single Family - Detached,87,84,3,0.0344827586206897
50,2050,Mobile Home,0,0,0,
50,2050,Multifamily,2636,2321,315,0.119499241274659
50,2050,Single Family - Detached,78,76,2,0.0256410256410256
51,2012,Mobile Home,0,0,0,
51,2012,Multifamily,4083,3230,853,0.208915013470487
51,2012,Single Family - Detached,90,92,-2,-0.0222222222222222
51,2020,Mobile Home,0,0,0,
51,2020,Multifamily,4829,3825,1004,0.207910540484572
51,2020,Single Family - Detached,56,55,1,0.0178571428571429
51,2025,Mobile Home,0,0,0,
51,2025,Multifamily,5113,4075,1038,0.203011930373558
51,2025,Single Family - Detached,56,56,0,0
51,2030,Mobile Home,0,0,0,
51,2030,Multifamily,5596,4478,1118,0.199785561115082
51,2030,Single Family - Detached,56,54,2,0.0357142857142857
51,2035,Mobile Home,0,0,0,
51,2035,Multifamily,6129,4735,1394,0.22744330233317
51,2035,Single Family - Detached,38,36,2,0.0526315789473684
51,2040,Mobile Home,0,0,0,
51,2040,Multifamily,6608,5324,1284,0.194309927360775
51,2040,Single Family - Detached,22,22,0,0
51,2045,Mobile Home,0,0,0,
51,2045,Multifamily,7617,6269,1348,0.17697256137587
51,2045,Single Family - Detached,22,21,1,0.0454545454545455
51,2050,Mobile Home,0,0,0,
51,2050,Multifamily,8463,7120,1343,0.158690771593997
51,2050,Single Family - Detached,17,18,-1,-0.0588235294117647
52,2012,Mobile Home,0,0,0,
52,2012,Multifamily,4155,2762,1393,0.3352587244284
52,2012,Single Family - Detached,25,22,3,0.12
52,2020,Mobile Home,0,0,0,
52,2020,Multifamily,6084,4168,1916,0.314924391847469
52,2020,Single Family - Detached,25,22,3,0.12
52,2025,Mobile Home,0,0,0,
52,2025,Multifamily,9051,7080,1971,0.217765992707988
52,2025,Single Family - Detached,25,24,1,0.04
52,2030,Mobile Home,0,0,0,
52,2030,Multifamily,10537,8313,2224,0.211065768245231
52,2030,Single Family - Detached,25,24,1,0.04
52,2035,Mobile Home,0,0,0,
52,2035,Multifamily,11633,9545,2088,0.179489383649961
52,2035,Single Family - Detached,25,25,0,0
52,2040,Mobile Home,0,0,0,
52,2040,Multifamily,12085,9567,2518,0.208357467935457
52,2040,Single Family - Detached,25,25,0,0
52,2045,Mobile Home,0,0,0,
52,2045,Multifamily,12168,9323,2845,0.233809993425378
52,2045,Single Family - Detached,25,25,0,0
52,2050,Mobile Home,0,0,0,
52,2050,Multifamily,12178,9209,2969,0.243800295615044
52,2050,Single Family - Detached,25,25,0,0
53,2012,Mobile Home,0,0,0,
53,2012,Multifamily,3839,2742,1097,0.285751497785882
53,2012,Single Family - Detached,1,2,-1,-1
53,2020,Mobile Home,0,0,0,
53,2020,Multifamily,4381,3155,1226,0.279844784295823
53,2020,Single Family - Detached,1,2,-1,-1
53,2025,Mobile Home,0,0,0,
53,2025,Multifamily,5231,3892,1339,0.255974001147008
53,2025,Single Family - Detached,1,2,-1,-1
53,2030,Mobile Home,0,0,0,
53,2030,Multifamily,5786,4208,1578,0.272727272727273
53,2030,Single Family - Detached,1,1,0,0
53,2035,Mobile Home,0,0,0,
53,2035,Multifamily,7019,5275,1744,0.248468442798119
53,2035,Single Family - Detached,1,2,-1,-1
53,2040,Mobile Home,0,0,0,
53,2040,Multifamily,7475,5758,1717,0.229698996655518
53,2040,Single Family - Detached,1,2,-1,-1
53,2045,Mobile Home,0,0,0,
53,2045,Multifamily,8067,6108,1959,0.242841204908888
53,2045,Single Family - Detached,1,2,-1,-1
53,2050,Mobile Home,0,0,0,
53,2050,Multifamily,8167,6078,2089,0.255785478143749
53,2050,Single Family - Detached,1,2,-1,-1
54,2012,Mobile Home,0,0,0,
54,2012,Multifamily,6371,4974,1397,0.219274839114739
54,2012,Single Family - Detached,3,2,1,0.333333333333333
54,2020,Mobile Home,0,0,0,
54,2020,Multifamily,6637,4911,1726,0.260057254783788
54,2020,Single Family - Detached,3,2,1,0.333333333333333
54,2025,Mobile Home,0,0,0,
54,2025,Multifamily,6637,4847,1790,0.269700165737532
54,2025,Single Family - Detached,3,3,0,0
54,2030,Mobile Home,0,0,0,
54,2030,Multifamily,6637,4743,1894,0.285369896037366
54,2030,Single Family - Detached,3,3,0,0
54,2035,Mobile Home,0,0,0,
54,2035,Multifamily,6637,4476,2161,0.325598915172518
54,2035,Single Family - Detached,3,3,0,0
54,2040,Mobile Home,0,0,0,
54,2040,Multifamily,6609,4247,2362,0.357391435920714
54,2040,Single Family - Detached,3,3,0,0
54,2045,Mobile Home,0,0,0,
54,2045,Multifamily,7125,4601,2524,0.354245614035088
54,2045,Single Family - Detached,3,3,0,0
54,2050,Mobile Home,0,0,0,
54,2050,Multifamily,7733,4935,2798,0.361825940773309
54,2050,Single Family - Detached,3,3,0,0
55,2012,Mobile Home,0,0,0,
55,2012,Multifamily,13,13,0,0
55,2012,Single Family - Detached,0,0,0,
55,2020,Mobile Home,0,0,0,
55,2020,Multifamily,13,13,0,0
55,2020,Single Family - Detached,0,0,0,
55,2025,Mobile Home,0,0,0,
55,2025,Multifamily,13,13,0,0
55,2025,Single Family - Detached,0,0,0,
55,2030,Mobile Home,0,0,0,
55,2030,Multifamily,13,13,0,0
55,2030,Single Family - Detached,0,0,0,
55,2035,Mobile Home,0,0,0,
55,2035,Multifamily,13,13,0,0
55,2035,Single Family - Detached,0,0,0,
55,2040,Mobile Home,0,0,0,
55,2040,Multifamily,13,13,0,0
55,2040,Single Family - Detached,0,0,0,
55,2045,Mobile Home,0,0,0,
55,2045,Multifamily,13,13,0,0
55,2045,Single Family - Detached,0,0,0,
55,2050,Mobile Home,0,0,0,
55,2050,Multifamily,13,13,0,0
55,2050,Single Family - Detached,0,0,0,
56,2012,Mobile Home,0,0,0,
56,2012,Multifamily,3211,2894,317,0.0987231392089692
56,2012,Single Family - Detached,15,21,-6,-0.4
56,2020,Mobile Home,0,0,0,
56,2020,Multifamily,3328,2874,454,0.136418269230769
56,2020,Single Family - Detached,15,20,-5,-0.333333333333333
56,2025,Mobile Home,0,0,0,
56,2025,Multifamily,4185,3772,413,0.0986857825567503
56,2025,Single Family - Detached,12,15,-3,-0.25
56,2030,Mobile Home,0,0,0,
56,2030,Multifamily,4681,4161,520,0.11108737449263
56,2030,Single Family - Detached,12,15,-3,-0.25
56,2035,Mobile Home,0,0,0,
56,2035,Multifamily,5336,4661,675,0.126499250374813
56,2035,Single Family - Detached,12,15,-3,-0.25
56,2040,Mobile Home,0,0,0,
56,2040,Multifamily,5616,4749,867,0.154380341880342
56,2040,Single Family - Detached,12,15,-3,-0.25
56,2045,Mobile Home,0,0,0,
56,2045,Multifamily,5620,4520,1100,0.195729537366548
56,2045,Single Family - Detached,12,15,-3,-0.25
56,2050,Mobile Home,0,0,0,
56,2050,Multifamily,5631,4403,1228,0.21807849405079
56,2050,Single Family - Detached,12,15,-3,-0.25
57,2012,Mobile Home,0,0,0,
57,2012,Multifamily,1103,843,260,0.235720761559384
57,2012,Single Family - Detached,49,49,0,0
57,2020,Mobile Home,0,0,0,
57,2020,Multifamily,1103,831,272,0.246600181323663
57,2020,Single Family - Detached,49,49,0,0
57,2025,Mobile Home,0,0,0,
57,2025,Multifamily,1103,830,273,0.247506799637353
57,2025,Single Family - Detached,49,50,-1,-0.0204081632653061
57,2030,Mobile Home,0,0,0,
57,2030,Multifamily,1103,808,295,0.267452402538531
57,2030,Single Family - Detached,49,47,2,0.0408163265306122
57,2035,Mobile Home,0,0,0,
57,2035,Multifamily,1163,844,319,0.274290627687016
57,2035,Single Family - Detached,49,48,1,0.0204081632653061
57,2040,Mobile Home,0,0,0,
57,2040,Multifamily,1200,862,338,0.281666666666667
57,2040,Single Family - Detached,45,43,2,0.0444444444444444
57,2045,Mobile Home,0,0,0,
57,2045,Multifamily,1330,974,356,0.267669172932331
57,2045,Single Family - Detached,33,27,6,0.181818181818182
57,2050,Mobile Home,0,0,0,
57,2050,Multifamily,1581,1273,308,0.194813409234662
57,2050,Single Family - Detached,19,14,5,0.263157894736842
58,2012,Mobile Home,0,0,0,
58,2012,Multifamily,2579,1630,949,0.367972082202404
58,2012,Single Family - Detached,84,55,29,0.345238095238095
58,2020,Mobile Home,0,0,0,
58,2020,Multifamily,2825,1893,932,0.329911504424779
58,2020,Single Family - Detached,84,55,29,0.345238095238095
58,2025,Mobile Home,0,0,0,
58,2025,Multifamily,2901,1922,979,0.337469837986901
58,2025,Single Family - Detached,84,60,24,0.285714285714286
58,2030,Mobile Home,0,0,0,
58,2030,Multifamily,3162,2185,977,0.308981657179001
58,2030,Single Family - Detached,78,55,23,0.294871794871795
58,2035,Mobile Home,0,0,0,
58,2035,Multifamily,4820,3750,1070,0.221991701244813
58,2035,Single Family - Detached,69,49,20,0.289855072463768
58,2040,Mobile Home,0,0,0,
58,2040,Multifamily,5317,4099,1218,0.229076546924958
58,2040,Single Family - Detached,55,38,17,0.309090909090909
58,2045,Mobile Home,0,0,0,
58,2045,Multifamily,5593,4280,1313,0.234757732880386
58,2045,Single Family - Detached,55,38,17,0.309090909090909
58,2050,Mobile Home,0,0,0,
58,2050,Multifamily,6293,4832,1461,0.232162720483076
58,2050,Single Family - Detached,51,34,17,0.333333333333333
59,2012,Mobile Home,0,0,0,
59,2012,Multifamily,1911,1707,204,0.106750392464678
59,2012,Single Family - Detached,227,205,22,0.0969162995594714
59,2020,Mobile Home,0,0,0,
59,2020,Multifamily,1911,1683,228,0.119309262166405
59,2020,Single Family - Detached,227,205,22,0.0969162995594714
59,2025,Mobile Home,0,0,0,
59,2025,Multifamily,1897,1672,225,0.118608328940432
59,2025,Single Family - Detached,227,212,15,0.066079295154185
59,2030,Mobile Home,0,0,0,
59,2030,Multifamily,2123,1894,229,0.107866227037211
59,2030,Single Family - Detached,224,206,18,0.0803571428571429
59,2035,Mobile Home,0,0,0,
59,2035,Multifamily,2488,2280,208,0.0836012861736334
59,2035,Single Family - Detached,196,182,14,0.0714285714285714
59,2040,Mobile Home,0,0,0,
59,2040,Multifamily,2721,2526,195,0.071664829106946
59,2040,Single Family - Detached,163,148,15,0.0920245398773006
59,2045,Mobile Home,0,0,0,
59,2045,Multifamily,2975,2774,201,0.067563025210084
59,2045,Single Family - Detached,109,100,9,0.0825688073394495
59,2050,Mobile Home,0,0,0,
59,2050,Multifamily,3078,2850,228,0.0740740740740741
59,2050,Single Family - Detached,76,68,8,0.105263157894737
6,2012,Mobile Home,0,0,0,
6,2012,Multifamily,1471,1395,76,0.0516655336505778
6,2012,Single Family - Detached,516,484,32,0.062015503875969
6,2020,Mobile Home,0,0,0,
6,2020,Multifamily,1472,1394,78,0.0529891304347826
6,2020,Single Family - Detached,554,534,20,0.036101083032491
6,2025,Mobile Home,0,0,0,
6,2025,Multifamily,2015,1936,79,0.0392059553349876
6,2025,Single Family - Detached,474,465,9,0.0189873417721519
6,2030,Mobile Home,0,0,0,
6,2030,Multifamily,2346,2247,99,0.0421994884910486
6,2030,Single Family - Detached,451,445,6,0.0133037694013304
6,2035,Mobile Home,0,0,0,
6,2035,Multifamily,2835,2710,125,0.0440917107583774
6,2035,Single Family - Detached,451,446,5,0.0110864745011086
6,2040,Mobile Home,0,0,0,
6,2040,Multifamily,2835,2672,163,0.0574955908289242
6,2040,Single Family - Detached,451,442,9,0.0199556541019956
6,2045,Mobile Home,0,0,0,
6,2045,Multifamily,2835,2636,199,0.0701940035273369
6,2045,Single Family - Detached,451,441,10,0.0221729490022173
6,2050,Mobile Home,0,0,0,
6,2050,Multifamily,2835,2603,232,0.0818342151675485
6,2050,Single Family - Detached,451,437,14,0.0310421286031042
60,2012,Mobile Home,0,0,0,
60,2012,Multifamily,1684,1554,130,0.0771971496437055
60,2012,Single Family - Detached,565,520,45,0.079646017699115
60,2020,Mobile Home,0,0,0,
60,2020,Multifamily,1841,1688,153,0.0831070070613797
60,2020,Single Family - Detached,551,509,42,0.0762250453720508
60,2025,Mobile Home,0,0,0,
60,2025,Multifamily,2799,2631,168,0.060021436227224
60,2025,Single Family - Detached,522,484,38,0.0727969348659004
60,2030,Mobile Home,0,0,0,
60,2030,Multifamily,3315,3123,192,0.0579185520361991
60,2030,Single Family - Detached,491,458,33,0.0672097759674134
60,2035,Mobile Home,0,0,0,
60,2035,Multifamily,3493,3285,208,0.0595476667620956
60,2035,Single Family - Detached,475,446,29,0.0610526315789474
60,2040,Mobile Home,0,0,0,
60,2040,Multifamily,3554,3300,254,0.0714687675858188
60,2040,Single Family - Detached,458,429,29,0.0633187772925764
60,2045,Mobile Home,0,0,0,
60,2045,Multifamily,3637,3308,329,0.0904591696453121
60,2045,Single Family - Detached,428,395,33,0.0771028037383178
60,2050,Mobile Home,0,0,0,
60,2050,Multifamily,3643,3222,421,0.115564095525666
60,2050,Single Family - Detached,430,395,35,0.0813953488372093
61,2012,Mobile Home,0,0,0,
61,2012,Multifamily,602,571,31,0.0514950166112957
61,2012,Single Family - Detached,659,607,52,0.078907435508346
61,2020,Mobile Home,0,0,0,
61,2020,Multifamily,602,549,53,0.0880398671096345
61,2020,Single Family - Detached,649,597,52,0.0801232665639445
61,2025,Mobile Home,0,0,0,
61,2025,Multifamily,604,538,66,0.109271523178808
61,2025,Single Family - Detached,649,609,40,0.061633281972265
61,2030,Mobile Home,0,0,0,
61,2030,Multifamily,620,515,105,0.169354838709677
61,2030,Single Family - Detached,641,603,38,0.0592823712948518
61,2035,Mobile Home,0,0,0,
61,2035,Multifamily,717,594,123,0.171548117154812
61,2035,Single Family - Detached,611,575,36,0.0589198036006547
61,2040,Mobile Home,0,0,0,
61,2040,Multifamily,745,599,146,0.195973154362416
61,2040,Single Family - Detached,601,564,37,0.0615640599001664
61,2045,Mobile Home,0,0,0,
61,2045,Multifamily,913,754,159,0.174151150054765
61,2045,Single Family - Detached,547,514,33,0.0603290676416819
61,2050,Mobile Home,0,0,0,
61,2050,Multifamily,1134,967,167,0.147266313932981
61,2050,Single Family - Detached,503,473,30,0.0596421471172962
62,2012,Mobile Home,0,0,0,
62,2012,Multifamily,78,76,2,0.0256410256410256
62,2012,Single Family - Detached,0,0,0,
62,2020,Mobile Home,0,0,0,
62,2020,Multifamily,78,78,0,0
62,2020,Single Family - Detached,0,0,0,
62,2025,Mobile Home,0,0,0,
62,2025,Multifamily,78,78,0,0
62,2025,Single Family - Detached,0,0,0,
62,2030,Mobile Home,0,0,0,
62,2030,Multifamily,78,78,0,0
62,2030,Single Family - Detached,0,0,0,
62,2035,Mobile Home,0,0,0,
62,2035,Multifamily,78,78,0,0
62,2035,Single Family - Detached,0,0,0,
62,2040,Mobile Home,0,0,0,
62,2040,Multifamily,78,78,0,0
62,2040,Single Family - Detached,0,0,0,
62,2045,Mobile Home,0,0,0,
62,2045,Multifamily,78,78,0,0
62,2045,Single Family - Detached,0,0,0,
62,2050,Mobile Home,0,0,0,
62,2050,Multifamily,78,78,0,0
62,2050,Single Family - Detached,0,0,0,
63,2012,Mobile Home,0,0,0,
63,2012,Multifamily,7,7,0,0
63,2012,Single Family - Detached,0,0,0,
63,2020,Mobile Home,0,0,0,
63,2020,Multifamily,7,7,0,0
63,2020,Single Family - Detached,0,0,0,
63,2025,Mobile Home,0,0,0,
63,2025,Multifamily,7,7,0,0
63,2025,Single Family - Detached,0,0,0,
63,2030,Mobile Home,0,0,0,
63,2030,Multifamily,7,7,0,0
63,2030,Single Family - Detached,0,0,0,
63,2035,Mobile Home,0,0,0,
63,2035,Multifamily,7,7,0,0
63,2035,Single Family - Detached,0,0,0,
63,2040,Mobile Home,0,0,0,
63,2040,Multifamily,7,7,0,0
63,2040,Single Family - Detached,0,0,0,
63,2045,Mobile Home,0,0,0,
63,2045,Multifamily,7,7,0,0
63,2045,Single Family - Detached,0,0,0,
63,2050,Mobile Home,0,0,0,
63,2050,Multifamily,7,7,0,0
63,2050,Single Family - Detached,0,0,0,
65,2012,Mobile Home,0,0,0,
65,2012,Multifamily,1190,1155,35,0.0294117647058824
65,2012,Single Family - Detached,258,255,3,0.0116279069767442
65,2020,Mobile Home,0,0,0,
65,2020,Multifamily,1189,1155,34,0.0285954583683768
65,2020,Single Family - Detached,258,245,13,0.0503875968992248
65,2025,Mobile Home,0,0,0,
65,2025,Multifamily,2161,2076,85,0.039333641832485
65,2025,Single Family - Detached,244,240,4,0.0163934426229508
65,2030,Mobile Home,0,0,0,
65,2030,Multifamily,2816,2703,113,0.0401278409090909
65,2030,Single Family - Detached,238,228,10,0.0420168067226891
65,2035,Mobile Home,0,0,0,
65,2035,Multifamily,3416,3277,139,0.0406908665105386
65,2035,Single Family - Detached,194,190,4,0.0206185567010309
65,2040,Mobile Home,0,0,0,
65,2040,Multifamily,3907,3739,168,0.0429997440491426
65,2040,Single Family - Detached,192,185,7,0.0364583333333333
65,2045,Mobile Home,0,0,0,
65,2045,Multifamily,4426,4221,205,0.0463172164482603
65,2045,Single Family - Detached,191,178,13,0.0680628272251309
65,2050,Mobile Home,0,0,0,
65,2050,Multifamily,4806,4589,217,0.0451518934665002
65,2050,Single Family - Detached,175,161,14,0.08
66,2012,Mobile Home,0,0,0,
66,2012,Multifamily,31,31,0,0
66,2012,Single Family - Detached,470,462,8,0.0170212765957447
66,2020,Mobile Home,0,0,0,
66,2020,Multifamily,31,31,0,0
66,2020,Single Family - Detached,470,462,8,0.0170212765957447
66,2025,Mobile Home,0,0,0,
66,2025,Multifamily,33,33,0,0
66,2025,Single Family - Detached,470,463,7,0.0148936170212766
66,2030,Mobile Home,0,0,0,
66,2030,Multifamily,37,33,4,0.108108108108108
66,2030,Single Family - Detached,470,463,7,0.0148936170212766
66,2035,Mobile Home,0,0,0,
66,2035,Multifamily,190,180,10,0.0526315789473684
66,2035,Single Family - Detached,470,464,6,0.0127659574468085
66,2040,Mobile Home,0,0,0,
66,2040,Multifamily,190,175,15,0.0789473684210526
66,2040,Single Family - Detached,470,464,6,0.0127659574468085
66,2045,Mobile Home,0,0,0,
66,2045,Multifamily,190,169,21,0.110526315789474
66,2045,Single Family - Detached,470,464,6,0.0127659574468085
66,2050,Mobile Home,0,0,0,
66,2050,Multifamily,304,282,22,0.0723684210526316
66,2050,Single Family - Detached,470,464,6,0.0127659574468085
68.01,2012,Mobile Home,0,0,0,
68.01,2012,Multifamily,1250,1196,54,0.0432
68.01,2012,Single Family - Detached,205,157,48,0.234146341463415
68.01,2020,Mobile Home,0,0,0,
68.01,2020,Multifamily,1250,1196,54,0.0432
68.01,2020,Single Family - Detached,205,157,48,0.234146341463415
68.01,2025,Mobile Home,0,0,0,
68.01,2025,Multifamily,1250,1198,52,0.0416
68.01,2025,Single Family - Detached,205,157,48,0.234146341463415
68.01,2030,Mobile Home,0,0,0,
68.01,2030,Multifamily,1286,1271,15,0.0116640746500778
68.01,2030,Single Family - Detached,197,196,1,0.0050761421319797
68.01,2035,Mobile Home,0,0,0,
68.01,2035,Multifamily,1286,1271,15,0.0116640746500778
68.01,2035,Single Family - Detached,197,196,1,0.0050761421319797
68.01,2040,Mobile Home,0,0,0,
68.01,2040,Multifamily,1286,1270,16,0.0124416796267496
68.01,2040,Single Family - Detached,197,196,1,0.0050761421319797
68.01,2045,Mobile Home,0,0,0,
68.01,2045,Multifamily,1294,1275,19,0.0146831530139104
68.01,2045,Single Family - Detached,197,196,1,0.0050761421319797
68.01,2050,Mobile Home,0,0,0,
68.01,2050,Multifamily,1296,1266,30,0.0231481481481481
68.01,2050,Single Family - Detached,197,196,1,0.0050761421319797
68.02,2012,Mobile Home,0,0,0,
68.02,2012,Multifamily,2260,2062,198,0.0876106194690266
68.02,2012,Single Family - Detached,217,208,9,0.0414746543778802
68.02,2020,Mobile Home,0,0,0,
68.02,2020,Multifamily,2274,2075,199,0.0875109938434477
68.02,2020,Single Family - Detached,218,208,10,0.0458715596330275
68.02,2025,Mobile Home,0,0,0,
68.02,2025,Multifamily,2562,2368,194,0.0757220921155347
68.02,2025,Single Family - Detached,218,209,9,0.0412844036697248
68.02,2030,Mobile Home,0,0,0,
68.02,2030,Multifamily,2663,2448,215,0.0807360120165227
68.02,2030,Single Family - Detached,218,208,10,0.0458715596330275
68.02,2035,Mobile Home,0,0,0,
68.02,2035,Multifamily,2716,2503,213,0.0784241531664212
68.02,2035,Single Family - Detached,215,205,10,0.0465116279069767
68.02,2040,Mobile Home,0,0,0,
68.02,2040,Multifamily,2775,2550,225,0.0810810810810811
68.02,2040,Single Family - Detached,215,203,12,0.0558139534883721
68.02,2045,Mobile Home,0,0,0,
68.02,2045,Multifamily,2796,2552,244,0.0872675250357654
68.02,2045,Single Family - Detached,215,202,13,0.0604651162790698
68.02,2050,Mobile Home,0,0,0,
68.02,2050,Multifamily,2985,2763,222,0.0743718592964824
68.02,2050,Single Family - Detached,218,207,11,0.0504587155963303
69,2012,Mobile Home,0,0,0,
69,2012,Multifamily,621,597,24,0.0386473429951691
69,2012,Single Family - Detached,1597,1580,17,0.010644959298685
69,2020,Mobile Home,0,0,0,
69,2020,Multifamily,606,581,25,0.0412541254125413
69,2020,Single Family - Detached,1597,1576,21,0.013149655604258
69,2025,Mobile Home,0,0,0,
69,2025,Multifamily,633,610,23,0.0363349131121643
69,2025,Single Family - Detached,1597,1577,20,0.0125234815278647
69,2030,Mobile Home,0,0,0,
69,2030,Multifamily,760,738,22,0.0289473684210526
69,2030,Single Family - Detached,1586,1538,48,0.0302648171500631
69,2035,Mobile Home,0,0,0,
69,2035,Multifamily,872,857,15,0.0172018348623853
69,2035,Single Family - Detached,1586,1541,45,0.0283732660781841
69,2040,Mobile Home,0,0,0,
69,2040,Multifamily,1045,1020,25,0.0239234449760766
69,2040,Single Family - Detached,1564,1515,49,0.0313299232736573
69,2045,Mobile Home,0,0,0,
69,2045,Multifamily,1182,1143,39,0.032994923857868
69,2045,Single Family - Detached,1564,1509,55,0.0351662404092072
69,2050,Mobile Home,0,0,0,
69,2050,Multifamily,1254,1184,70,0.0558213716108453
69,2050,Single Family - Detached,1564,1504,60,0.0383631713554987
7,2012,Mobile Home,0,0,0,
7,2012,Multifamily,1730,1658,72,0.0416184971098266
7,2012,Single Family - Detached,727,700,27,0.0371389270976616
7,2020,Mobile Home,0,0,0,
7,2020,Multifamily,1734,1641,93,0.0536332179930796
7,2020,Single Family - Detached,756,722,34,0.044973544973545
7,2025,Mobile Home,0,0,0,
7,2025,Multifamily,1734,1629,105,0.0605536332179931
7,2025,Single Family - Detached,756,725,31,0.041005291005291
7,2030,Mobile Home,0,0,0,
7,2030,Multifamily,2100,2028,72,0.0342857142857143
7,2030,Single Family - Detached,681,655,26,0.0381791483113069
7,2035,Mobile Home,0,0,0,
7,2035,Multifamily,2261,2190,71,0.0314020344980097
7,2035,Single Family - Detached,635,614,21,0.0330708661417323
7,2040,Mobile Home,0,0,0,
7,2040,Multifamily,2454,2370,84,0.0342298288508557
7,2040,Single Family - Detached,556,537,19,0.0341726618705036
7,2045,Mobile Home,0,0,0,
7,2045,Multifamily,2457,2345,112,0.0455840455840456
7,2045,Single Family - Detached,556,535,21,0.0377697841726619
7,2050,Mobile Home,0,0,0,
7,2050,Multifamily,2457,2314,143,0.0582010582010582
7,2050,Single Family - Detached,556,531,25,0.0449640287769784
70.02,2012,Mobile Home,0,0,0,
70.02,2012,Multifamily,0,0,0,
70.02,2012,Single Family - Detached,1255,1214,41,0.0326693227091633
70.02,2020,Mobile Home,0,0,0,
70.02,2020,Multifamily,0,0,0,
70.02,2020,Single Family - Detached,1256,1213,43,0.0342356687898089
70.02,2025,Mobile Home,0,0,0,
70.02,2025,Multifamily,0,0,0,
70.02,2025,Single Family - Detached,1256,1215,41,0.0326433121019108
70.02,2030,Mobile Home,0,0,0,
70.02,2030,Multifamily,0,0,0,
70.02,2030,Single Family - Detached,1256,1215,41,0.0326433121019108
70.02,2035,Mobile Home,0,0,0,
70.02,2035,Multifamily,0,0,0,
70.02,2035,Single Family - Detached,1256,1216,40,0.0318471337579618
70.02,2040,Mobile Home,0,0,0,
70.02,2040,Multifamily,0,0,0,
70.02,2040,Single Family - Detached,1256,1216,40,0.0318471337579618
70.02,2045,Mobile Home,0,0,0,
70.02,2045,Multifamily,0,0,0,
70.02,2045,Single Family - Detached,1266,1237,29,0.0229067930489731
70.02,2050,Mobile Home,0,0,0,
70.02,2050,Multifamily,0,0,0,
70.02,2050,Single Family - Detached,1266,1235,31,0.0244865718799368
71,2012,Mobile Home,0,0,0,
71,2012,Multifamily,724,658,66,0.0911602209944751
71,2012,Single Family - Detached,1727,1653,74,0.0428488708743486
71,2020,Mobile Home,0,0,0,
71,2020,Multifamily,724,657,67,0.0925414364640884
71,2020,Single Family - Detached,1727,1650,77,0.0445859872611465
71,2025,Mobile Home,0,0,0,
71,2025,Multifamily,724,655,69,0.0953038674033149
71,2025,Single Family - Detached,1727,1660,67,0.0387955993051534
71,2030,Mobile Home,0,0,0,
71,2030,Multifamily,724,652,72,0.0994475138121547
71,2030,Single Family - Detached,1727,1660,67,0.0387955993051534
71,2035,Mobile Home,0,0,0,
71,2035,Multifamily,724,650,74,0.102209944751381
71,2035,Single Family - Detached,1727,1667,60,0.0347423277359583
71,2040,Mobile Home,0,0,0,
71,2040,Multifamily,1011,941,70,0.0692383778437191
71,2040,Single Family - Detached,1682,1624,58,0.0344827586206897
71,2045,Mobile Home,0,0,0,
71,2045,Multifamily,1063,992,71,0.0667920978363123
71,2045,Single Family - Detached,1676,1611,65,0.0387828162291169
71,2050,Mobile Home,0,0,0,
71,2050,Multifamily,1083,1012,71,0.0655586334256694
71,2050,Single Family - Detached,1674,1622,52,0.031063321385902
72,2012,Mobile Home,0,0,0,
72,2012,Multifamily,6,4,2,0.333333333333333
72,2012,Single Family - Detached,1632,1577,55,0.0337009803921569
72,2020,Mobile Home,0,0,0,
72,2020,Multifamily,6,3,3,0.5
72,2020,Single Family - Detached,1633,1581,52,0.031843233312921
72,2025,Mobile Home,0,0,0,
72,2025,Multifamily,6,2,4,0.666666666666667
72,2025,Single Family - Detached,1633,1598,35,0.0214329454990814
72,2030,Mobile Home,0,0,0,
72,2030,Multifamily,6,1,5,0.833333333333333
72,2030,Single Family - Detached,1633,1598,35,0.0214329454990814
72,2035,Mobile Home,0,0,0,
72,2035,Multifamily,6,0,6,1
72,2035,Single Family - Detached,1633,1605,28,0.0171463563992652
72,2040,Mobile Home,0,0,0,
72,2040,Multifamily,6,0,6,1
72,2040,Single Family - Detached,1633,1603,30,0.0183710961420698
72,2045,Mobile Home,0,0,0,
72,2045,Multifamily,4,2,2,0.5
72,2045,Single Family - Detached,1633,1599,34,0.0208205756276791
72,2050,Mobile Home,0,0,0,
72,2050,Multifamily,37,31,6,0.162162162162162
72,2050,Single Family - Detached,1633,1597,36,0.0220453153704838
73.01,2012,Mobile Home,0,0,0,
73.01,2012,Multifamily,1674,1555,119,0.0710872162485066
73.01,2012,Single Family - Detached,1319,1239,80,0.0606520090978014
73.01,2020,Mobile Home,0,0,0,
73.01,2020,Multifamily,1674,1547,127,0.0758661887694146
73.01,2020,Single Family - Detached,1319,1229,90,0.0682335102350265
73.01,2025,Mobile Home,0,0,0,
73.01,2025,Multifamily,1674,1555,119,0.0710872162485066
73.01,2025,Single Family - Detached,1315,1239,76,0.0577946768060836
73.01,2030,Mobile Home,0,0,0,
73.01,2030,Multifamily,1693,1561,132,0.0779681039574719
73.01,2030,Single Family - Detached,1314,1237,77,0.058599695585997
73.01,2035,Mobile Home,0,0,0,
73.01,2035,Multifamily,1702,1567,135,0.0793184488836663
73.01,2035,Single Family - Detached,1314,1239,75,0.0570776255707763
73.01,2040,Mobile Home,0,0,0,
73.01,2040,Multifamily,1723,1574,149,0.0864770748694138
73.01,2040,Single Family - Detached,1312,1232,80,0.0609756097560976
73.01,2045,Mobile Home,0,0,0,
73.01,2045,Multifamily,1754,1582,172,0.0980615735461802
73.01,2045,Single Family - Detached,1307,1219,88,0.0673297628156083
73.01,2050,Mobile Home,0,0,0,
73.01,2050,Multifamily,1928,1777,151,0.0783195020746888
73.01,2050,Single Family - Detached,1244,1173,71,0.0570739549839228
73.02,2012,Mobile Home,0,0,0,
73.02,2012,Multifamily,16,16,0,0
73.02,2012,Single Family - Detached,864,847,17,0.0196759259259259
73.02,2020,Mobile Home,0,0,0,
73.02,2020,Multifamily,16,14,2,0.125
73.02,2020,Single Family - Detached,864,847,17,0.0196759259259259
73.02,2025,Mobile Home,0,0,0,
73.02,2025,Multifamily,18,17,1,0.0555555555555556
73.02,2025,Single Family - Detached,864,852,12,0.0138888888888889
73.02,2030,Mobile Home,0,0,0,
73.02,2030,Multifamily,20,16,4,0.2
73.02,2030,Single Family - Detached,864,852,12,0.0138888888888889
73.02,2035,Mobile Home,0,0,0,
73.02,2035,Multifamily,20,15,5,0.25
73.02,2035,Single Family - Detached,864,853,11,0.0127314814814815
73.02,2040,Mobile Home,0,0,0,
73.02,2040,Multifamily,20,12,8,0.4
73.02,2040,Single Family - Detached,864,853,11,0.0127314814814815
73.02,2045,Mobile Home,0,0,0,
73.02,2045,Multifamily,20,9,11,0.55
73.02,2045,Single Family - Detached,864,853,11,0.0127314814814815
73.02,2050,Mobile Home,0,0,0,
73.02,2050,Multifamily,20,5,15,0.75
73.02,2050,Single Family - Detached,864,850,14,0.0162037037037037
74,2012,Mobile Home,0,0,0,
74,2012,Multifamily,1462,1423,39,0.0266757865937072
74,2012,Single Family - Detached,1714,1672,42,0.0245040840140023
74,2020,Mobile Home,0,0,0,
74,2020,Multifamily,1504,1458,46,0.0305851063829787
74,2020,Single Family - Detached,1713,1664,49,0.028604786923526
74,2025,Mobile Home,0,0,0,
74,2025,Multifamily,1520,1485,35,0.0230263157894737
74,2025,Single Family - Detached,1713,1666,47,0.0274372446001168
74,2030,Mobile Home,0,0,0,
74,2030,Multifamily,1655,1576,79,0.0477341389728097
74,2030,Single Family - Detached,1672,1605,67,0.0400717703349282
74,2035,Mobile Home,0,0,0,
74,2035,Multifamily,1639,1564,75,0.0457596095179988
74,2035,Single Family - Detached,1670,1609,61,0.0365269461077844
74,2040,Mobile Home,0,0,0,
74,2040,Multifamily,1776,1681,95,0.053490990990991
74,2040,Single Family - Detached,1630,1565,65,0.0398773006134969
74,2045,Mobile Home,0,0,0,
74,2045,Multifamily,2075,1968,107,0.051566265060241
74,2045,Single Family - Detached,1521,1453,68,0.0447074293228139
74,2050,Mobile Home,0,0,0,
74,2050,Multifamily,2641,2507,134,0.0507383566830746
74,2050,Single Family - Detached,1382,1318,64,0.0463096960926194
75.01,2012,Mobile Home,0,0,0,
75.01,2012,Multifamily,1026,962,64,0.0623781676413255
75.01,2012,Single Family - Detached,1329,1291,38,0.0285929270127916
75.01,2020,Mobile Home,0,0,0,
75.01,2020,Multifamily,1025,975,50,0.0487804878048781
75.01,2020,Single Family - Detached,1318,1282,36,0.0273141122913505
75.01,2025,Mobile Home,0,0,0,
75.01,2025,Multifamily,1179,1131,48,0.0407124681933842
75.01,2025,Single Family - Detached,1310,1286,24,0.0183206106870229
75.01,2030,Mobile Home,0,0,0,
75.01,2030,Multifamily,1421,1371,50,0.0351864883884588
75.01,2030,Single Family - Detached,1252,1229,23,0.018370607028754
75.01,2035,Mobile Home,0,0,0,
75.01,2035,Multifamily,1514,1472,42,0.0277410832232497
75.01,2035,Single Family - Detached,1195,1182,13,0.0108786610878661
75.01,2040,Mobile Home,0,0,0,
75.01,2040,Multifamily,1541,1494,47,0.0304996755353666
75.01,2040,Single Family - Detached,1177,1163,14,0.0118946474086661
75.01,2045,Mobile Home,0,0,0,
75.01,2045,Multifamily,1566,1517,49,0.0312899106002554
75.01,2045,Single Family - Detached,1153,1135,18,0.01561144839549
75.01,2050,Mobile Home,0,0,0,
75.01,2050,Multifamily,1566,1477,89,0.0568326947637292
75.01,2050,Single Family - Detached,1158,1125,33,0.0284974093264249
75.02,2012,Mobile Home,0,0,0,
75.02,2012,Multifamily,1002,944,58,0.0578842315369262
75.02,2012,Single Family - Detached,830,808,22,0.0265060240963855
75.02,2020,Mobile Home,0,0,0,
75.02,2020,Multifamily,1002,936,66,0.0658682634730539
75.02,2020,Single Family - Detached,845,817,28,0.0331360946745562
75.02,2025,Mobile Home,0,0,0,
75.02,2025,Multifamily,991,935,56,0.0565085771947528
75.02,2025,Single Family - Detached,832,810,22,0.0264423076923077
75.02,2030,Mobile Home,0,0,0,
75.02,2030,Multifamily,1114,1048,66,0.059245960502693
75.02,2030,Single Family - Detached,817,795,22,0.0269277845777234
75.02,2035,Mobile Home,0,0,0,
75.02,2035,Multifamily,1276,1205,71,0.0556426332288401
75.02,2035,Single Family - Detached,807,785,22,0.0272614622057001
75.02,2040,Mobile Home,0,0,0,
75.02,2040,Multifamily,1402,1322,80,0.0570613409415121
75.02,2040,Single Family - Detached,807,781,26,0.0322180916976456
75.02,2045,Mobile Home,0,0,0,
75.02,2045,Multifamily,1518,1436,82,0.0540184453227932
75.02,2045,Single Family - Detached,792,767,25,0.0315656565656566
75.02,2050,Mobile Home,0,0,0,
75.02,2050,Multifamily,1754,1651,103,0.0587229190421893
75.02,2050,Single Family - Detached,761,737,24,0.0315374507227332
76,2012,Mobile Home,232,196,36,0.155172413793103
76,2012,Multifamily,1959,1309,650,0.331801939765186
76,2012,Single Family - Detached,1852,1302,550,0.296976241900648
76,2020,Mobile Home,198,167,31,0.156565656565657
76,2020,Multifamily,2295,1503,792,0.345098039215686
76,2020,Single Family - Detached,1790,1217,573,0.320111731843575
76,2025,Mobile Home,186,157,29,0.155913978494624
76,2025,Multifamily,2453,1699,754,0.307378719934774
76,2025,Single Family - Detached,1755,1292,463,0.263817663817664
76,2030,Mobile Home,174,146,28,0.160919540229885
76,2030,Multifamily,2584,1777,807,0.312306501547988
76,2030,Single Family - Detached,1696,1239,457,0.269457547169811
76,2035,Mobile Home,159,136,23,0.144654088050314
76,2035,Multifamily,2699,1889,810,0.300111152278622
76,2035,Single Family - Detached,1634,1223,411,0.251529987760098
76,2040,Mobile Home,120,104,16,0.133333333333333
76,2040,Multifamily,2884,1985,899,0.311719833564494
76,2040,Single Family - Detached,1529,1122,407,0.266187050359712
76,2045,Mobile Home,79,68,11,0.139240506329114
76,2045,Multifamily,2986,2008,978,0.327528466175486
76,2045,Single Family - Detached,1466,1043,423,0.288540245566166
76,2050,Mobile Home,36,30,6,0.166666666666667
76,2050,Multifamily,2986,2007,979,0.327863362357669
76,2050,Single Family - Detached,1466,1043,423,0.288540245566166
77.01,2012,Mobile Home,0,0,0,
77.01,2012,Multifamily,1786,1568,218,0.122060470324748
77.01,2012,Single Family - Detached,549,524,25,0.0455373406193078
77.01,2020,Mobile Home,0,0,0,
77.01,2020,Multifamily,1798,1589,209,0.116240266963293
77.01,2020,Single Family - Detached,549,520,29,0.0528233151183971
77.01,2025,Mobile Home,0,0,0,
77.01,2025,Multifamily,1798,1590,208,0.115684093437152
77.01,2025,Single Family - Detached,549,525,24,0.0437158469945355
77.01,2030,Mobile Home,0,0,0,
77.01,2030,Multifamily,1846,1636,210,0.113759479956663
77.01,2030,Single Family - Detached,505,484,21,0.0415841584158416
77.01,2035,Mobile Home,0,0,0,
77.01,2035,Multifamily,2067,2025,42,0.0203193033381713
77.01,2035,Single Family - Detached,347,337,10,0.0288184438040346
77.01,2040,Mobile Home,0,0,0,
77.01,2040,Multifamily,2067,2015,52,0.0251572327044025
77.01,2040,Single Family - Detached,347,335,12,0.0345821325648415
77.01,2045,Mobile Home,0,0,0,
77.01,2045,Multifamily,2067,2004,63,0.0304789550072569
77.01,2045,Single Family - Detached,347,333,14,0.0403458213256484
77.01,2050,Mobile Home,0,0,0,
77.01,2050,Multifamily,2067,2004,63,0.0304789550072569
77.01,2050,Single Family - Detached,347,332,15,0.0432276657060519
77.02,2012,Mobile Home,0,0,0,
77.02,2012,Multifamily,1563,1532,31,0.0198336532309661
77.02,2012,Single Family - Detached,677,659,18,0.0265878877400295
77.02,2020,Mobile Home,0,0,0,
77.02,2020,Multifamily,1682,1630,52,0.0309155766944114
77.02,2020,Single Family - Detached,594,580,14,0.0235690235690236
77.02,2025,Mobile Home,0,0,0,
77.02,2025,Multifamily,1682,1637,45,0.0267538644470868
77.02,2025,Single Family - Detached,594,582,12,0.0202020202020202
77.02,2030,Mobile Home,0,0,0,
77.02,2030,Multifamily,1983,1940,43,0.021684316691881
77.02,2030,Single Family - Detached,367,360,7,0.0190735694822888
77.02,2035,Mobile Home,0,0,0,
77.02,2035,Multifamily,1983,1897,86,0.043368633383762
77.02,2035,Single Family - Detached,367,360,7,0.0190735694822888
77.02,2040,Mobile Home,0,0,0,
77.02,2040,Multifamily,1983,1873,110,0.0554715078164397
77.02,2040,Single Family - Detached,367,358,9,0.0245231607629428
77.02,2045,Mobile Home,0,0,0,
77.02,2045,Multifamily,1983,1844,139,0.070095814422592
77.02,2045,Single Family - Detached,367,356,11,0.0299727520435967
77.02,2050,Mobile Home,0,0,0,
77.02,2050,Multifamily,1983,1837,146,0.0736258194654564
77.02,2050,Single Family - Detached,367,355,12,0.0326975476839237
78,2012,Mobile Home,0,0,0,
78,2012,Multifamily,1535,1472,63,0.041042345276873
78,2012,Single Family - Detached,1105,1084,21,0.0190045248868778
78,2020,Mobile Home,0,0,0,
78,2020,Multifamily,2017,1957,60,0.029747149231532
78,2020,Single Family - Detached,870,848,22,0.0252873563218391
78,2025,Mobile Home,0,0,0,
78,2025,Multifamily,2017,1961,56,0.0277640059494298
78,2025,Single Family - Detached,870,856,14,0.0160919540229885
78,2030,Mobile Home,0,0,0,
78,2030,Multifamily,2017,1945,72,0.0356965790778384
78,2030,Single Family - Detached,870,854,16,0.0183908045977011
78,2035,Mobile Home,0,0,0,
78,2035,Multifamily,2017,1898,119,0.0589985126425384
78,2035,Single Family - Detached,870,850,20,0.0229885057471264
78,2040,Mobile Home,0,0,0,
78,2040,Multifamily,2017,1873,144,0.0713931581556767
78,2040,Single Family - Detached,870,846,24,0.0275862068965517
78,2045,Mobile Home,0,0,0,
78,2045,Multifamily,2017,1844,173,0.0857709469509172
78,2045,Single Family - Detached,870,844,26,0.0298850574712644
78,2050,Mobile Home,0,0,0,
78,2050,Multifamily,2017,1838,179,0.0887456618740704
78,2050,Single Family - Detached,871,842,29,0.0332950631458094
79.03,2012,Mobile Home,0,0,0,
79.03,2012,Multifamily,2001,1909,92,0.0459770114942529
79.03,2012,Single Family - Detached,586,574,12,0.0204778156996587
79.03,2020,Mobile Home,0,0,0,
79.03,2020,Multifamily,2222,2120,102,0.0459045904590459
79.03,2020,Single Family - Detached,445,437,8,0.0179775280898876
79.03,2025,Mobile Home,0,0,0,
79.03,2025,Multifamily,2253,2166,87,0.0386151797603196
79.03,2025,Single Family - Detached,413,412,1,0.00242130750605327
79.03,2030,Mobile Home,0,0,0,
79.03,2030,Multifamily,2559,2491,68,0.0265728800312622
79.03,2030,Single Family - Detached,334,330,4,0.0119760479041916
79.03,2035,Mobile Home,0,0,0,
79.03,2035,Multifamily,2840,2732,108,0.0380281690140845
79.03,2035,Single Family - Detached,271,265,6,0.022140221402214
79.03,2040,Mobile Home,0,0,0,
79.03,2040,Multifamily,2840,2704,136,0.047887323943662
79.03,2040,Single Family - Detached,271,262,9,0.033210332103321
79.03,2045,Mobile Home,0,0,0,
79.03,2045,Multifamily,2840,2664,176,0.0619718309859155
79.03,2045,Single Family - Detached,271,259,12,0.044280442804428
79.03,2050,Mobile Home,0,0,0,
79.03,2050,Multifamily,2840,2658,182,0.0640845070422535
79.03,2050,Single Family - Detached,271,259,12,0.044280442804428
79.05,2012,Mobile Home,0,0,0,
79.05,2012,Multifamily,1129,1001,128,0.113374667847653
79.05,2012,Single Family - Detached,443,422,21,0.0474040632054176
79.05,2020,Mobile Home,0,0,0,
79.05,2020,Multifamily,1140,981,159,0.139473684210526
79.05,2020,Single Family - Detached,443,413,30,0.0677200902934537
79.05,2025,Mobile Home,0,0,0,
79.05,2025,Multifamily,1140,1002,138,0.121052631578947
79.05,2025,Single Family - Detached,443,428,15,0.0338600451467269
79.05,2030,Mobile Home,0,0,0,
79.05,2030,Multifamily,1135,982,153,0.134801762114537
79.05,2030,Single Family - Detached,442,426,16,0.0361990950226244
79.05,2035,Mobile Home,0,0,0,
79.05,2035,Multifamily,1630,1444,186,0.114110429447853
79.05,2035,Single Family - Detached,373,359,14,0.0375335120643432
79.05,2040,Mobile Home,0,0,0,
79.05,2040,Multifamily,1902,1723,179,0.0941114616193481
79.05,2040,Single Family - Detached,295,277,18,0.0610169491525424
79.05,2045,Mobile Home,0,0,0,
79.05,2045,Multifamily,2343,2230,113,0.0482287665386257
79.05,2045,Single Family - Detached,235,213,22,0.0936170212765957
79.05,2050,Mobile Home,0,0,0,
79.05,2050,Multifamily,2453,2341,112,0.0456583774969425
79.05,2050,Single Family - Detached,231,210,21,0.0909090909090909
79.07,2012,Mobile Home,0,0,0,
79.07,2012,Multifamily,1221,1159,62,0.0507780507780508
79.07,2012,Single Family - Detached,507,481,26,0.0512820512820513
79.07,2020,Mobile Home,0,0,0,
79.07,2020,Multifamily,1226,1136,90,0.0734094616639478
79.07,2020,Single Family - Detached,507,481,26,0.0512820512820513
79.07,2025,Mobile Home,0,0,0,
79.07,2025,Multifamily,1218,1147,71,0.0582922824302135
79.07,2025,Single Family - Detached,507,485,22,0.0433925049309665
79.07,2030,Mobile Home,0,0,0,
79.07,2030,Multifamily,1308,1221,87,0.0665137614678899
79.07,2030,Single Family - Detached,460,437,23,0.05
79.07,2035,Mobile Home,0,0,0,
79.07,2035,Multifamily,2013,1933,80,0.0397416790859414
79.07,2035,Single Family - Detached,238,236,2,0.00840336134453781
79.07,2040,Mobile Home,0,0,0,
79.07,2040,Multifamily,2013,1909,104,0.0516641828117238
79.07,2040,Single Family - Detached,238,234,4,0.0168067226890756
79.07,2045,Mobile Home,0,0,0,
79.07,2045,Multifamily,2013,1875,138,0.0685543964232489
79.07,2045,Single Family - Detached,238,232,6,0.0252100840336134
79.07,2050,Mobile Home,0,0,0,
79.07,2050,Multifamily,2013,1870,143,0.0710382513661202
79.07,2050,Single Family - Detached,238,232,6,0.0252100840336134
79.08,2012,Mobile Home,0,0,0,
79.08,2012,Multifamily,965,913,52,0.0538860103626943
79.08,2012,Single Family - Detached,582,552,30,0.0515463917525773
79.08,2020,Mobile Home,0,0,0,
79.08,2020,Multifamily,1566,1504,62,0.0395913154533844
79.08,2020,Single Family - Detached,324,308,16,0.0493827160493827
79.08,2025,Mobile Home,0,0,0,
79.08,2025,Multifamily,1664,1616,48,0.0288461538461538
79.08,2025,Single Family - Detached,324,313,11,0.0339506172839506
79.08,2030,Mobile Home,0,0,0,
79.08,2030,Multifamily,2008,1946,62,0.0308764940239044
79.08,2030,Single Family - Detached,175,175,0,0
79.08,2035,Mobile Home,0,0,0,
79.08,2035,Multifamily,2008,1895,113,0.0562749003984064
79.08,2035,Single Family - Detached,175,175,0,0
79.08,2040,Mobile Home,0,0,0,
79.08,2040,Multifamily,2008,1867,141,0.0702191235059761
79.08,2040,Single Family - Detached,175,175,0,0
79.08,2045,Mobile Home,0,0,0,
79.08,2045,Multifamily,2008,1830,178,0.0886454183266932
79.08,2045,Single Family - Detached,175,175,0,0
79.08,2050,Mobile Home,0,0,0,
79.08,2050,Multifamily,2008,1823,185,0.0921314741035857
79.08,2050,Single Family - Detached,175,175,0,0
79.10,2012,Mobile Home,0,0,0,
79.10,2012,Multifamily,1136,1045,91,0.0801056338028169
79.10,2012,Single Family - Detached,558,537,21,0.0376344086021505
79.10,2020,Mobile Home,0,0,0,
79.10,2020,Multifamily,1136,1006,130,0.11443661971831
79.10,2020,Single Family - Detached,558,531,27,0.0483870967741935
79.10,2025,Mobile Home,0,0,0,
79.10,2025,Multifamily,1136,1024,112,0.0985915492957746
79.10,2025,Single Family - Detached,558,539,19,0.0340501792114695
79.10,2030,Mobile Home,0,0,0,
79.10,2030,Multifamily,1111,986,125,0.112511251125113
79.10,2030,Single Family - Detached,558,536,22,0.039426523297491
79.10,2035,Mobile Home,0,0,0,
79.10,2035,Multifamily,1790,1637,153,0.0854748603351955
79.10,2035,Single Family - Detached,327,315,12,0.036697247706422
79.10,2040,Mobile Home,0,0,0,
79.10,2040,Multifamily,2050,1891,159,0.0775609756097561
79.10,2040,Single Family - Detached,309,303,6,0.0194174757281553
79.10,2045,Mobile Home,0,0,0,
79.10,2045,Multifamily,2890,2705,185,0.0640138408304498
79.10,2045,Single Family - Detached,286,282,4,0.013986013986014
79.10,2050,Mobile Home,0,0,0,
79.10,2050,Multifamily,2890,2700,190,0.0657439446366782
79.10,2050,Single Family - Detached,286,282,4,0.013986013986014
8,2012,Mobile Home,0,0,0,
8,2012,Multifamily,1776,1665,111,0.0625
8,2012,Single Family - Detached,862,838,24,0.0278422273781903
8,2020,Mobile Home,0,0,0,
8,2020,Multifamily,1859,1823,36,0.0193652501344809
8,2020,Single Family - Detached,843,821,22,0.0260972716488731
8,2025,Mobile Home,0,0,0,
8,2025,Multifamily,1859,1825,34,0.0182894029047875
8,2025,Single Family - Detached,843,830,13,0.0154211150652432
8,2030,Mobile Home,0,0,0,
8,2030,Multifamily,1859,1819,40,0.0215169445938677
8,2030,Single Family - Detached,843,829,14,0.0166073546856465
8,2035,Mobile Home,0,0,0,
8,2035,Multifamily,1859,1818,41,0.0220548682087144
8,2035,Single Family - Detached,843,830,13,0.0154211150652432
8,2040,Mobile Home,0,0,0,
8,2040,Multifamily,1859,1808,51,0.0274341043571813
8,2040,Single Family - Detached,843,829,14,0.0166073546856465
8,2045,Mobile Home,0,0,0,
8,2045,Multifamily,1859,1790,69,0.0371167294244217
8,2045,Single Family - Detached,843,828,15,0.0177935943060498
8,2050,Mobile Home,0,0,0,
8,2050,Multifamily,1859,1758,101,0.0543302850995159
8,2050,Single Family - Detached,843,827,16,0.0189798339264531
80.02,2012,Mobile Home,0,0,0,
80.02,2012,Multifamily,91,91,0,0
80.02,2012,Single Family - Detached,997,975,22,0.0220661985957874
80.02,2020,Mobile Home,0,0,0,
80.02,2020,Multifamily,139,122,17,0.122302158273381
80.02,2020,Single Family - Detached,968,945,23,0.0237603305785124
80.02,2025,Mobile Home,0,0,0,
80.02,2025,Multifamily,139,128,11,0.079136690647482
80.02,2025,Single Family - Detached,968,946,22,0.0227272727272727
80.02,2030,Mobile Home,0,0,0,
80.02,2030,Multifamily,161,145,16,0.0993788819875776
80.02,2030,Single Family - Detached,948,926,22,0.0232067510548523
80.02,2035,Mobile Home,0,0,0,
80.02,2035,Multifamily,175,144,31,0.177142857142857
80.02,2035,Single Family - Detached,934,912,22,0.0235546038543897
80.02,2040,Mobile Home,0,0,0,
80.02,2040,Multifamily,175,132,43,0.245714285714286
80.02,2040,Single Family - Detached,934,911,23,0.0246252676659529
80.02,2045,Mobile Home,0,0,0,
80.02,2045,Multifamily,175,120,55,0.314285714285714
80.02,2045,Single Family - Detached,934,910,24,0.0256959314775161
80.02,2050,Mobile Home,0,0,0,
80.02,2050,Multifamily,175,114,61,0.348571428571429
80.02,2050,Single Family - Detached,934,909,25,0.0267665952890792
80.03,2012,Mobile Home,0,0,0,
80.03,2012,Multifamily,892,842,50,0.0560538116591928
80.03,2012,Single Family - Detached,936,891,45,0.0480769230769231
80.03,2020,Mobile Home,0,0,0,
80.03,2020,Multifamily,892,817,75,0.0840807174887892
80.03,2020,Single Family - Detached,936,889,47,0.0502136752136752
80.03,2025,Mobile Home,0,0,0,
80.03,2025,Multifamily,892,827,65,0.0728699551569507
80.03,2025,Single Family - Detached,936,892,44,0.047008547008547
80.03,2030,Mobile Home,0,0,0,
80.03,2030,Multifamily,869,795,74,0.0851553509781358
80.03,2030,Single Family - Detached,921,880,41,0.0445168295331162
80.03,2035,Mobile Home,0,0,0,
80.03,2035,Multifamily,1190,1102,88,0.0739495798319328
80.03,2035,Single Family - Detached,796,758,38,0.0477386934673367
80.03,2040,Mobile Home,0,0,0,
80.03,2040,Multifamily,1492,1402,90,0.0603217158176944
80.03,2040,Single Family - Detached,636,597,39,0.0613207547169811
80.03,2045,Mobile Home,0,0,0,
80.03,2045,Multifamily,1550,1446,104,0.0670967741935484
80.03,2045,Single Family - Detached,582,545,37,0.063573883161512
80.03,2050,Mobile Home,0,0,0,
80.03,2050,Multifamily,1550,1442,108,0.0696774193548387
80.03,2050,Single Family - Detached,582,545,37,0.063573883161512
80.06,2012,Mobile Home,0,0,0,
80.06,2012,Multifamily,1364,1247,117,0.0857771260997067
80.06,2012,Single Family - Detached,758,745,13,0.0171503957783641
80.06,2020,Mobile Home,0,0,0,
80.06,2020,Multifamily,1453,1343,110,0.075705437026841
80.06,2020,Single Family - Detached,756,742,14,0.0185185185185185
80.06,2025,Mobile Home,0,0,0,
80.06,2025,Multifamily,1461,1355,106,0.0725530458590007
80.06,2025,Single Family - Detached,756,744,12,0.0158730158730159
80.06,2030,Mobile Home,0,0,0,
80.06,2030,Multifamily,1519,1380,139,0.0915075707702436
80.06,2030,Single Family - Detached,756,744,12,0.0158730158730159
80.06,2035,Mobile Home,0,0,0,
80.06,2035,Multifamily,1801,1621,180,0.0999444752915047
80.06,2035,Single Family - Detached,706,696,10,0.0141643059490085
80.06,2040,Mobile Home,0,0,0,
80.06,2040,Multifamily,2213,2022,191,0.0863081789426118
80.06,2040,Single Family - Detached,642,635,7,0.0109034267912773
80.06,2045,Mobile Home,0,0,0,
80.06,2045,Multifamily,2494,2279,215,0.0862068965517241
80.06,2045,Single Family - Detached,601,590,11,0.0183028286189684
80.06,2050,Mobile Home,0,0,0,
80.06,2050,Multifamily,2515,2310,205,0.0815109343936382
80.06,2050,Single Family - Detached,601,589,12,0.0199667221297837
81.01,2012,Mobile Home,0,0,0,
81.01,2012,Multifamily,630,529,101,0.16031746031746
81.01,2012,Single Family - Detached,1656,1530,126,0.0760869565217391
81.01,2020,Mobile Home,0,0,0,
81.01,2020,Multifamily,599,446,153,0.25542570951586
81.01,2020,Single Family - Detached,1641,1516,125,0.0761730652041438
81.01,2025,Mobile Home,0,0,0,
81.01,2025,Multifamily,599,461,138,0.230383973288815
81.01,2025,Single Family - Detached,1641,1541,100,0.0609384521633151
81.01,2030,Mobile Home,0,0,0,
81.01,2030,Multifamily,603,385,218,0.361525704809287
81.01,2030,Single Family - Detached,1641,1541,100,0.0609384521633151
81.01,2035,Mobile Home,0,0,0,
81.01,2035,Multifamily,818,530,288,0.352078239608802
81.01,2035,Single Family - Detached,1624,1542,82,0.0504926108374384
81.01,2040,Mobile Home,0,0,0,
81.01,2040,Multifamily,1188,841,347,0.292087542087542
81.01,2040,Single Family - Detached,1603,1514,89,0.0555208983156581
81.01,2045,Mobile Home,0,0,0,
81.01,2045,Multifamily,1408,1070,338,0.240056818181818
81.01,2045,Single Family - Detached,1551,1479,72,0.04642166344294
81.01,2050,Mobile Home,0,0,0,
81.01,2050,Multifamily,1408,1052,356,0.252840909090909
81.01,2050,Single Family - Detached,1551,1476,75,0.0483558994197292
81.02,2012,Mobile Home,0,0,0,
81.02,2012,Multifamily,342,314,28,0.0818713450292398
81.02,2012,Single Family - Detached,1178,1107,71,0.0602716468590832
81.02,2020,Mobile Home,0,0,0,
81.02,2020,Multifamily,350,283,67,0.191428571428571
81.02,2020,Single Family - Detached,1178,1096,82,0.0696095076400679
81.02,2025,Mobile Home,0,0,0,
81.02,2025,Multifamily,350,290,60,0.171428571428571
81.02,2025,Single Family - Detached,1178,1113,65,0.0551782682512733
81.02,2030,Mobile Home,0,0,0,
81.02,2030,Multifamily,350,243,107,0.305714285714286
81.02,2030,Single Family - Detached,1178,1112,66,0.0560271646859083
81.02,2035,Mobile Home,0,0,0,
81.02,2035,Multifamily,350,212,138,0.394285714285714
81.02,2035,Single Family - Detached,1178,1113,65,0.0551782682512733
81.02,2040,Mobile Home,0,0,0,
81.02,2040,Multifamily,353,221,132,0.373937677053824
81.02,2040,Single Family - Detached,1177,1100,77,0.0654205607476635
81.02,2045,Mobile Home,0,0,0,
81.02,2045,Multifamily,548,378,170,0.31021897810219
81.02,2045,Single Family - Detached,1177,1088,89,0.0756159728122345
81.02,2050,Mobile Home,0,0,0,
81.02,2050,Multifamily,550,389,161,0.292727272727273
81.02,2050,Single Family - Detached,1177,1087,90,0.0764655904842821
82,2012,Mobile Home,0,0,0,
82,2012,Multifamily,1900,1324,576,0.303157894736842
82,2012,Single Family - Detached,442,380,62,0.14027149321267
82,2020,Mobile Home,0,0,0,
82,2020,Multifamily,2374,1741,633,0.266638584667228
82,2020,Single Family - Detached,441,359,82,0.1859410430839
82,2025,Mobile Home,0,0,0,
82,2025,Multifamily,2530,1948,582,0.2300395256917
82,2025,Single Family - Detached,441,395,46,0.104308390022676
82,2030,Mobile Home,0,0,0,
82,2030,Multifamily,3425,2798,627,0.183065693430657
82,2030,Single Family - Detached,435,380,55,0.126436781609195
82,2035,Mobile Home,0,0,0,
82,2035,Multifamily,3816,3239,577,0.151205450733753
82,2035,Single Family - Detached,416,388,28,0.0673076923076923
82,2040,Mobile Home,0,0,0,
82,2040,Multifamily,4000,3338,662,0.1655
82,2040,Single Family - Detached,411,362,49,0.119221411192214
82,2045,Mobile Home,0,0,0,
82,2045,Multifamily,4023,3249,774,0.192393736017897
82,2045,Single Family - Detached,411,340,71,0.172749391727494
82,2050,Mobile Home,0,0,0,
82,2050,Multifamily,4023,3219,804,0.199850857568978
82,2050,Single Family - Detached,411,332,79,0.192214111922141
83.01,2012,Mobile Home,0,0,0,
83.01,2012,Multifamily,120,107,13,0.108333333333333
83.01,2012,Single Family - Detached,1174,1147,27,0.0229982964224872
83.01,2020,Mobile Home,0,0,0,
83.01,2020,Multifamily,120,106,14,0.116666666666667
83.01,2020,Single Family - Detached,1192,1162,30,0.0251677852348993
83.01,2025,Mobile Home,0,0,0,
83.01,2025,Multifamily,120,106,14,0.116666666666667
83.01,2025,Single Family - Detached,1193,1168,25,0.0209555741827326
83.01,2030,Mobile Home,0,0,0,
83.01,2030,Multifamily,120,105,15,0.125
83.01,2030,Single Family - Detached,1194,1169,25,0.0209380234505863
83.01,2035,Mobile Home,0,0,0,
83.01,2035,Multifamily,120,103,17,0.141666666666667
83.01,2035,Single Family - Detached,1195,1170,25,0.0209205020920502
83.01,2040,Mobile Home,0,0,0,
83.01,2040,Multifamily,120,102,18,0.15
83.01,2040,Single Family - Detached,1196,1167,29,0.024247491638796
83.01,2045,Mobile Home,0,0,0,
83.01,2045,Multifamily,120,100,20,0.166666666666667
83.01,2045,Single Family - Detached,1196,1165,31,0.0259197324414716
83.01,2050,Mobile Home,0,0,0,
83.01,2050,Multifamily,120,100,20,0.166666666666667
83.01,2050,Single Family - Detached,1197,1166,31,0.0258980785296575
83.03,2012,Mobile Home,0,0,0,
83.03,2012,Multifamily,307,249,58,0.188925081433225
83.03,2012,Single Family - Detached,1454,1279,175,0.120357634112792
83.03,2020,Mobile Home,0,0,0,
83.03,2020,Multifamily,313,287,26,0.0830670926517572
83.03,2020,Single Family - Detached,1451,1262,189,0.130254996554101
83.03,2025,Mobile Home,0,0,0,
83.03,2025,Multifamily,313,288,25,0.0798722044728434
83.03,2025,Single Family - Detached,1468,1316,152,0.103542234332425
83.03,2030,Mobile Home,0,0,0,
83.03,2030,Multifamily,353,309,44,0.124645892351275
83.03,2030,Single Family - Detached,1474,1319,155,0.105156037991859
83.03,2035,Mobile Home,0,0,0,
83.03,2035,Multifamily,356,304,52,0.146067415730337
83.03,2035,Single Family - Detached,1473,1324,149,0.101154107264087
83.03,2040,Mobile Home,0,0,0,
83.03,2040,Multifamily,356,288,68,0.191011235955056
83.03,2040,Single Family - Detached,1495,1332,163,0.109030100334448
83.03,2045,Mobile Home,0,0,0,
83.03,2045,Multifamily,356,275,81,0.22752808988764
83.03,2045,Single Family - Detached,1495,1311,184,0.123076923076923
83.03,2050,Mobile Home,0,0,0,
83.03,2050,Multifamily,356,271,85,0.23876404494382
83.03,2050,Single Family - Detached,1497,1306,191,0.127588510354041
83.05,2012,Mobile Home,0,0,0,
83.05,2012,Multifamily,700,696,4,0.00571428571428571
83.05,2012,Single Family - Detached,120,120,0,0
83.05,2020,Mobile Home,0,0,0,
83.05,2020,Multifamily,700,700,0,0
83.05,2020,Single Family - Detached,120,120,0,0
83.05,2025,Mobile Home,0,0,0,
83.05,2025,Multifamily,700,700,0,0
83.05,2025,Single Family - Detached,120,120,0,0
83.05,2030,Mobile Home,0,0,0,
83.05,2030,Multifamily,700,700,0,0
83.05,2030,Single Family - Detached,120,119,1,0.00833333333333333
83.05,2035,Mobile Home,0,0,0,
83.05,2035,Multifamily,700,700,0,0
83.05,2035,Single Family - Detached,120,120,0,0
83.05,2040,Mobile Home,0,0,0,
83.05,2040,Multifamily,700,698,2,0.00285714285714286
83.05,2040,Single Family - Detached,120,120,0,0
83.05,2045,Mobile Home,0,0,0,
83.05,2045,Multifamily,700,698,2,0.00285714285714286
83.05,2045,Single Family - Detached,120,120,0,0
83.05,2050,Mobile Home,0,0,0,
83.05,2050,Multifamily,700,698,2,0.00285714285714286
83.05,2050,Single Family - Detached,120,120,0,0
83.06,2012,Mobile Home,0,0,0,
83.06,2012,Multifamily,0,0,0,
83.06,2012,Single Family - Detached,1206,1184,22,0.0182421227197347
83.06,2020,Mobile Home,0,0,0,
83.06,2020,Multifamily,0,0,0,
83.06,2020,Single Family - Detached,1206,1181,25,0.0207296849087894
83.06,2025,Mobile Home,0,0,0,
83.06,2025,Multifamily,0,0,0,
83.06,2025,Single Family - Detached,1212,1196,16,0.0132013201320132
83.06,2030,Mobile Home,0,0,0,
83.06,2030,Multifamily,0,0,0,
83.06,2030,Single Family - Detached,1219,1203,16,0.0131255127153404
83.06,2035,Mobile Home,0,0,0,
83.06,2035,Multifamily,0,0,0,
83.06,2035,Single Family - Detached,1223,1209,14,0.0114472608340147
83.06,2040,Mobile Home,0,0,0,
83.06,2040,Multifamily,0,0,0,
83.06,2040,Single Family - Detached,1233,1215,18,0.0145985401459854
83.06,2045,Mobile Home,0,0,0,
83.06,2045,Multifamily,0,0,0,
83.06,2045,Single Family - Detached,1235,1213,22,0.0178137651821862
83.06,2050,Mobile Home,0,0,0,
83.06,2050,Multifamily,0,0,0,
83.06,2050,Single Family - Detached,1242,1220,22,0.0177133655394525
83.07,2012,Mobile Home,0,0,0,
83.07,2012,Multifamily,346,334,12,0.0346820809248555
83.07,2012,Single Family - Detached,1257,1242,15,0.0119331742243437
83.07,2020,Mobile Home,0,0,0,
83.07,2020,Multifamily,346,322,24,0.069364161849711
83.07,2020,Single Family - Detached,1258,1240,18,0.014308426073132
83.07,2025,Mobile Home,0,0,0,
83.07,2025,Multifamily,346,327,19,0.0549132947976879
83.07,2025,Single Family - Detached,1260,1247,13,0.0103174603174603
83.07,2030,Mobile Home,0,0,0,
83.07,2030,Multifamily,346,327,19,0.0549132947976879
83.07,2030,Single Family - Detached,1260,1247,13,0.0103174603174603
83.07,2035,Mobile Home,0,0,0,
83.07,2035,Multifamily,346,329,17,0.0491329479768786
83.07,2035,Single Family - Detached,1260,1250,10,0.00793650793650794
83.07,2040,Mobile Home,0,0,0,
83.07,2040,Multifamily,346,325,21,0.0606936416184971
83.07,2040,Single Family - Detached,1260,1248,12,0.00952380952380952
83.07,2045,Mobile Home,0,0,0,
83.07,2045,Multifamily,346,324,22,0.0635838150289017
83.07,2045,Single Family - Detached,1260,1246,14,0.0111111111111111
83.07,2050,Mobile Home,0,0,0,
83.07,2050,Multifamily,346,323,23,0.0664739884393064
83.07,2050,Single Family - Detached,1260,1245,15,0.0119047619047619
83.10,2012,Mobile Home,0,0,0,
83.10,2012,Multifamily,8,8,0,0
83.10,2012,Single Family - Detached,2540,2277,263,0.103543307086614
83.10,2020,Mobile Home,0,0,0,
83.10,2020,Multifamily,12,1,11,0.916666666666667
83.10,2020,Single Family - Detached,2549,2273,276,0.108277755982738
83.10,2025,Mobile Home,0,0,0,
83.10,2025,Multifamily,12,3,9,0.75
83.10,2025,Single Family - Detached,2549,2295,254,0.0996469203609259
83.10,2030,Mobile Home,0,0,0,
83.10,2030,Multifamily,12,0,12,1
83.10,2030,Single Family - Detached,2549,2295,254,0.0996469203609259
83.10,2035,Mobile Home,0,0,0,
83.10,2035,Multifamily,12,0,12,1
83.10,2035,Single Family - Detached,2549,2295,254,0.0996469203609259
83.10,2040,Mobile Home,0,0,0,
83.10,2040,Multifamily,12,0,12,1
83.10,2040,Single Family - Detached,2575,2341,234,0.090873786407767
83.10,2045,Mobile Home,0,0,0,
83.10,2045,Multifamily,12,0,12,1
83.10,2045,Single Family - Detached,2575,2329,246,0.0955339805825243
83.10,2050,Mobile Home,0,0,0,
83.10,2050,Multifamily,12,0,12,1
83.10,2050,Single Family - Detached,2575,2328,247,0.0959223300970874
83.11,2012,Mobile Home,0,0,0,
83.11,2012,Multifamily,0,0,0,
83.11,2012,Single Family - Detached,1190,1120,70,0.0588235294117647
83.11,2020,Mobile Home,0,0,0,
83.11,2020,Multifamily,0,0,0,
83.11,2020,Single Family - Detached,1190,1115,75,0.0630252100840336
83.11,2025,Mobile Home,0,0,0,
83.11,2025,Multifamily,0,0,0,
83.11,2025,Single Family - Detached,1190,1124,66,0.0554621848739496
83.11,2030,Mobile Home,0,0,0,
83.11,2030,Multifamily,0,0,0,
83.11,2030,Single Family - Detached,1191,1123,68,0.0570948782535684
83.11,2035,Mobile Home,0,0,0,
83.11,2035,Multifamily,0,0,0,
83.11,2035,Single Family - Detached,1192,1125,67,0.0562080536912752
83.11,2040,Mobile Home,0,0,0,
83.11,2040,Multifamily,0,0,0,
83.11,2040,Single Family - Detached,1196,1121,75,0.0627090301003344
83.11,2045,Mobile Home,0,0,0,
83.11,2045,Multifamily,0,0,0,
83.11,2045,Single Family - Detached,1196,1116,80,0.0668896321070234
83.11,2050,Mobile Home,0,0,0,
83.11,2050,Multifamily,0,0,0,
83.11,2050,Single Family - Detached,1196,1115,81,0.0677257525083612
83.12,2012,Mobile Home,0,0,0,
83.12,2012,Multifamily,821,638,183,0.222898903775883
83.12,2012,Single Family - Detached,1213,1024,189,0.155812036273702
83.12,2020,Mobile Home,0,0,0,
83.12,2020,Multifamily,904,699,205,0.226769911504425
83.12,2020,Single Family - Detached,1213,1008,205,0.169002473206925
83.12,2025,Mobile Home,0,0,0,
83.12,2025,Multifamily,1008,807,201,0.199404761904762
83.12,2025,Single Family - Detached,1192,1023,169,0.141778523489933
83.12,2030,Mobile Home,0,0,0,
83.12,2030,Multifamily,1098,876,222,0.202185792349727
83.12,2030,Single Family - Detached,1208,1036,172,0.142384105960265
83.12,2035,Mobile Home,0,0,0,
83.12,2035,Multifamily,1099,886,213,0.193812556869882
83.12,2035,Single Family - Detached,1215,1056,159,0.130864197530864
83.12,2040,Mobile Home,0,0,0,
83.12,2040,Multifamily,1102,880,222,0.201451905626134
83.12,2040,Single Family - Detached,1232,1059,173,0.140422077922078
83.12,2045,Mobile Home,0,0,0,
83.12,2045,Multifamily,1102,880,222,0.201451905626134
83.12,2045,Single Family - Detached,1245,1074,171,0.137349397590361
83.12,2050,Mobile Home,0,0,0,
83.12,2050,Multifamily,1102,880,222,0.201451905626134
83.12,2050,Single Family - Detached,1247,1072,175,0.140336808340016
83.13,2012,Mobile Home,0,0,0,
83.13,2012,Multifamily,0,0,0,
83.13,2012,Single Family - Detached,930,880,50,0.0537634408602151
83.13,2020,Mobile Home,0,0,0,
83.13,2020,Multifamily,0,0,0,
83.13,2020,Single Family - Detached,931,877,54,0.0580021482277121
83.13,2025,Mobile Home,0,0,0,
83.13,2025,Multifamily,0,0,0,
83.13,2025,Single Family - Detached,955,911,44,0.0460732984293194
83.13,2030,Mobile Home,0,0,0,
83.13,2030,Multifamily,0,0,0,
83.13,2030,Single Family - Detached,957,909,48,0.0501567398119122
83.13,2035,Mobile Home,0,0,0,
83.13,2035,Multifamily,0,0,0,
83.13,2035,Single Family - Detached,957,910,47,0.0491118077324974
83.13,2040,Mobile Home,0,0,0,
83.13,2040,Multifamily,0,0,0,
83.13,2040,Single Family - Detached,957,908,49,0.0512016718913271
83.13,2045,Mobile Home,0,0,0,
83.13,2045,Multifamily,0,0,0,
83.13,2045,Single Family - Detached,957,884,73,0.0762800417972832
83.13,2050,Mobile Home,0,0,0,
83.13,2050,Multifamily,0,0,0,
83.13,2050,Single Family - Detached,957,881,76,0.0794148380355277
83.24,2012,Mobile Home,0,0,0,
83.24,2012,Multifamily,543,539,4,0.00736648250460405
83.24,2012,Single Family - Detached,2528,2344,184,0.0727848101265823
83.24,2020,Mobile Home,0,0,0,
83.24,2020,Multifamily,544,544,0,0
83.24,2020,Single Family - Detached,2532,2332,200,0.0789889415481833
83.24,2025,Mobile Home,0,0,0,
83.24,2025,Multifamily,552,552,0,0
83.24,2025,Single Family - Detached,2540,2374,166,0.0653543307086614
83.24,2030,Mobile Home,0,0,0,
83.24,2030,Multifamily,579,579,0,0
83.24,2030,Single Family - Detached,2547,2378,169,0.066352571652925
83.24,2035,Mobile Home,0,0,0,
83.24,2035,Multifamily,580,580,0,0
83.24,2035,Single Family - Detached,2551,2394,157,0.0615444923559388
83.24,2040,Mobile Home,0,0,0,
83.24,2040,Multifamily,682,680,2,0.00293255131964809
83.24,2040,Single Family - Detached,2561,2393,168,0.0655993752440453
83.24,2045,Mobile Home,0,0,0,
83.24,2045,Multifamily,751,749,2,0.00266311584553928
83.24,2045,Single Family - Detached,2565,2382,183,0.0713450292397661
83.24,2050,Mobile Home,0,0,0,
83.24,2050,Multifamily,751,749,2,0.00266311584553928
83.24,2050,Single Family - Detached,2580,2391,189,0.0732558139534884
83.27,2012,Mobile Home,0,0,0,
83.27,2012,Multifamily,1057,1013,44,0.0416272469252602
83.27,2012,Single Family - Detached,1446,1398,48,0.033195020746888
83.27,2020,Mobile Home,0,0,0,
83.27,2020,Multifamily,1058,1010,48,0.0453686200378072
83.27,2020,Single Family - Detached,1446,1391,55,0.0380359612724758
83.27,2025,Mobile Home,0,0,0,
83.27,2025,Multifamily,1059,1019,40,0.0377714825306893
83.27,2025,Single Family - Detached,1447,1407,40,0.027643400138217
83.27,2030,Mobile Home,0,0,0,
83.27,2030,Multifamily,1059,1019,40,0.0377714825306893
83.27,2030,Single Family - Detached,1447,1407,40,0.027643400138217
83.27,2035,Mobile Home,0,0,0,
83.27,2035,Multifamily,1059,1020,39,0.0368271954674221
83.27,2035,Single Family - Detached,1449,1413,36,0.0248447204968944
83.27,2040,Mobile Home,0,0,0,
83.27,2040,Multifamily,1059,1018,41,0.0387157695939566
83.27,2040,Single Family - Detached,1449,1407,42,0.0289855072463768
83.27,2045,Mobile Home,0,0,0,
83.27,2045,Multifamily,1059,1017,42,0.0396600566572238
83.27,2045,Single Family - Detached,1449,1400,49,0.0338164251207729
83.27,2050,Mobile Home,0,0,0,
83.27,2050,Multifamily,1059,1016,43,0.040604343720491
83.27,2050,Single Family - Detached,1449,1396,53,0.0365769496204279
83.28,2012,Mobile Home,0,0,0,
83.28,2012,Multifamily,108,108,0,0
83.28,2012,Single Family - Detached,1671,1639,32,0.0191502094554159
83.28,2020,Mobile Home,0,0,0,
83.28,2020,Multifamily,108,108,0,0
83.28,2020,Single Family - Detached,2852,2815,37,0.0129733520336606
83.28,2025,Mobile Home,0,0,0,
83.28,2025,Multifamily,108,108,0,0
83.28,2025,Single Family - Detached,2855,2825,30,0.010507880910683
83.28,2030,Mobile Home,0,0,0,
83.28,2030,Multifamily,108,108,0,0
83.28,2030,Single Family - Detached,2858,2828,30,0.0104968509447166
83.28,2035,Mobile Home,0,0,0,
83.28,2035,Multifamily,108,108,0,0
83.28,2035,Single Family - Detached,2858,2831,27,0.00944716585024493
83.28,2040,Mobile Home,0,0,0,
83.28,2040,Multifamily,108,108,0,0
83.28,2040,Single Family - Detached,2863,2834,29,0.0101292350681104
83.28,2045,Mobile Home,0,0,0,
83.28,2045,Multifamily,108,108,0,0
83.28,2045,Single Family - Detached,2865,2833,32,0.0111692844677138
83.28,2050,Mobile Home,0,0,0,
83.28,2050,Multifamily,108,108,0,0
83.28,2050,Single Family - Detached,2872,2839,33,0.0114902506963788
83.29,2012,Mobile Home,0,0,0,
83.29,2012,Multifamily,3252,2981,271,0.0833333333333333
83.29,2012,Single Family - Detached,125,125,0,0
83.29,2020,Mobile Home,0,0,0,
83.29,2020,Multifamily,3252,2966,286,0.0879458794587946
83.29,2020,Single Family - Detached,125,123,2,0.016
83.29,2025,Mobile Home,0,0,0,
83.29,2025,Multifamily,3252,2990,262,0.0805658056580566
83.29,2025,Single Family - Detached,125,125,0,0
83.29,2030,Mobile Home,0,0,0,
83.29,2030,Multifamily,3252,2990,262,0.0805658056580566
83.29,2030,Single Family - Detached,125,124,1,0.008
83.29,2035,Mobile Home,0,0,0,
83.29,2035,Multifamily,3252,2993,259,0.0796432964329643
83.29,2035,Single Family - Detached,125,125,0,0
83.29,2040,Mobile Home,0,0,0,
83.29,2040,Multifamily,3252,2985,267,0.0821033210332103
83.29,2040,Single Family - Detached,125,123,2,0.016
83.29,2045,Mobile Home,0,0,0,
83.29,2045,Multifamily,3252,2984,268,0.0824108241082411
83.29,2045,Single Family - Detached,125,122,3,0.024
83.29,2050,Mobile Home,0,0,0,
83.29,2050,Multifamily,3252,2983,269,0.0827183271832718
83.29,2050,Single Family - Detached,125,121,4,0.032
83.30,2012,Mobile Home,0,0,0,
83.30,2012,Multifamily,898,842,56,0.0623608017817372
83.30,2012,Single Family - Detached,1196,1187,9,0.00752508361204013
83.30,2020,Mobile Home,0,0,0,
83.30,2020,Multifamily,898,839,59,0.0657015590200445
83.30,2020,Single Family - Detached,1196,1181,15,0.0125418060200669
83.30,2025,Mobile Home,0,0,0,
83.30,2025,Multifamily,898,847,51,0.0567928730512249
83.30,2025,Single Family - Detached,1196,1189,7,0.00585284280936455
83.30,2030,Mobile Home,0,0,0,
83.30,2030,Multifamily,898,847,51,0.0567928730512249
83.30,2030,Single Family - Detached,1196,1189,7,0.00585284280936455
83.30,2035,Mobile Home,0,0,0,
83.30,2035,Multifamily,898,848,50,0.0556792873051225
83.30,2035,Single Family - Detached,1196,1190,6,0.00501672240802676
83.30,2040,Mobile Home,0,0,0,
83.30,2040,Multifamily,898,848,50,0.0556792873051225
83.30,2040,Single Family - Detached,1196,1185,11,0.00919732441471572
83.30,2045,Mobile Home,0,0,0,
83.30,2045,Multifamily,898,848,50,0.0556792873051225
83.30,2045,Single Family - Detached,1196,1179,17,0.0142140468227425
83.30,2050,Mobile Home,0,0,0,
83.30,2050,Multifamily,898,848,50,0.0556792873051225
83.30,2050,Single Family - Detached,1196,1178,18,0.0150501672240803
83.31,2012,Mobile Home,0,0,0,
83.31,2012,Multifamily,0,0,0,
83.31,2012,Single Family - Detached,897,883,14,0.0156075808249721
83.31,2020,Mobile Home,0,0,0,
83.31,2020,Multifamily,5,3,2,0.4
83.31,2020,Single Family - Detached,897,882,15,0.0167224080267559
83.31,2025,Mobile Home,0,0,0,
83.31,2025,Multifamily,20,20,0,0
83.31,2025,Single Family - Detached,897,885,12,0.0133779264214047
83.31,2030,Mobile Home,0,0,0,
83.31,2030,Multifamily,20,20,0,0
83.31,2030,Single Family - Detached,897,885,12,0.0133779264214047
83.31,2035,Mobile Home,0,0,0,
83.31,2035,Multifamily,20,20,0,0
83.31,2035,Single Family - Detached,897,886,11,0.012263099219621
83.31,2040,Mobile Home,0,0,0,
83.31,2040,Multifamily,20,18,2,0.1
83.31,2040,Single Family - Detached,897,885,12,0.0133779264214047
83.31,2045,Mobile Home,0,0,0,
83.31,2045,Multifamily,20,16,4,0.2
83.31,2045,Single Family - Detached,897,882,15,0.0167224080267559
83.31,2050,Mobile Home,0,0,0,
83.31,2050,Multifamily,20,14,6,0.3
83.31,2050,Single Family - Detached,897,882,15,0.0167224080267559
83.33,2012,Mobile Home,0,0,0,
83.33,2012,Multifamily,1720,1708,12,0.00697674418604651
83.33,2012,Single Family - Detached,3301,3191,110,0.0333232353832172
83.33,2020,Mobile Home,0,0,0,
83.33,2020,Multifamily,2318,2306,12,0.00517687661777394
83.33,2020,Single Family - Detached,3426,3306,120,0.0350262697022767
83.33,2025,Mobile Home,0,0,0,
83.33,2025,Multifamily,2318,2310,8,0.00345125107851596
83.33,2025,Single Family - Detached,3431,3326,105,0.0306033226464588
83.33,2030,Mobile Home,0,0,0,
83.33,2030,Multifamily,2318,2310,8,0.00345125107851596
83.33,2030,Single Family - Detached,3435,3326,109,0.0317321688500728
83.33,2035,Mobile Home,0,0,0,
83.33,2035,Multifamily,2318,2312,6,0.00258843830888697
83.33,2035,Single Family - Detached,3436,3335,101,0.0293946449359721
83.33,2040,Mobile Home,0,0,0,
83.33,2040,Multifamily,2318,2307,11,0.00474547023295945
83.33,2040,Single Family - Detached,3441,3330,111,0.032258064516129
83.33,2045,Mobile Home,0,0,0,
83.33,2045,Multifamily,2318,2306,12,0.00517687661777394
83.33,2045,Single Family - Detached,3443,3326,117,0.0339819924484461
83.33,2050,Mobile Home,0,0,0,
83.33,2050,Multifamily,2318,2305,13,0.00560828300258844
83.33,2050,Single Family - Detached,3452,3334,118,0.0341830822711472
83.35,2012,Mobile Home,0,0,0,
83.35,2012,Multifamily,670,668,2,0.00298507462686567
83.35,2012,Single Family - Detached,2306,2287,19,0.00823937554206418
83.35,2020,Mobile Home,0,0,0,
83.35,2020,Multifamily,691,691,0,0
83.35,2020,Single Family - Detached,2471,2445,26,0.0105220558478349
83.35,2025,Mobile Home,0,0,0,
83.35,2025,Multifamily,691,691,0,0
83.35,2025,Single Family - Detached,2471,2455,16,0.00647511129097531
83.35,2030,Mobile Home,0,0,0,
83.35,2030,Multifamily,691,691,0,0
83.35,2030,Single Family - Detached,2471,2454,17,0.00687980574666127
83.35,2035,Mobile Home,0,0,0,
83.35,2035,Multifamily,691,691,0,0
83.35,2035,Single Family - Detached,2471,2457,14,0.0056657223796034
83.35,2040,Mobile Home,0,0,0,
83.35,2040,Multifamily,691,690,1,0.00144717800289436
83.35,2040,Single Family - Detached,2471,2452,19,0.00768919465803319
83.35,2045,Mobile Home,0,0,0,
83.35,2045,Multifamily,691,690,1,0.00144717800289436
83.35,2045,Single Family - Detached,2472,2448,24,0.00970873786407767
83.35,2050,Mobile Home,0,0,0,
83.35,2050,Multifamily,691,690,1,0.00144717800289436
83.35,2050,Single Family - Detached,2484,2459,25,0.0100644122383253
83.36,2012,Mobile Home,0,0,0,
83.36,2012,Multifamily,0,0,0,
83.36,2012,Single Family - Detached,742,738,4,0.00539083557951483
83.36,2020,Mobile Home,0,0,0,
83.36,2020,Multifamily,0,0,0,
83.36,2020,Single Family - Detached,742,735,7,0.00943396226415094
83.36,2025,Mobile Home,0,0,0,
83.36,2025,Multifamily,0,0,0,
83.36,2025,Single Family - Detached,742,740,2,0.00269541778975741
83.36,2030,Mobile Home,0,0,0,
83.36,2030,Multifamily,0,0,0,
83.36,2030,Single Family - Detached,742,740,2,0.00269541778975741
83.36,2035,Mobile Home,0,0,0,
83.36,2035,Multifamily,0,0,0,
83.36,2035,Single Family - Detached,742,741,1,0.00134770889487871
83.36,2040,Mobile Home,0,0,0,
83.36,2040,Multifamily,0,0,0,
83.36,2040,Single Family - Detached,742,738,4,0.00539083557951483
83.36,2045,Mobile Home,0,0,0,
83.36,2045,Multifamily,0,0,0,
83.36,2045,Single Family - Detached,742,735,7,0.00943396226415094
83.36,2050,Mobile Home,0,0,0,
83.36,2050,Multifamily,0,0,0,
83.36,2050,Single Family - Detached,742,735,7,0.00943396226415094
83.37,2012,Mobile Home,0,0,0,
83.37,2012,Multifamily,0,0,0,
83.37,2012,Single Family - Detached,1320,1310,10,0.00757575757575758
83.37,2020,Mobile Home,0,0,0,
83.37,2020,Multifamily,0,0,0,
83.37,2020,Single Family - Detached,1320,1310,10,0.00757575757575758
83.37,2025,Mobile Home,0,0,0,
83.37,2025,Multifamily,0,0,0,
83.37,2025,Single Family - Detached,1320,1313,7,0.0053030303030303
83.37,2030,Mobile Home,0,0,0,
83.37,2030,Multifamily,0,0,0,
83.37,2030,Single Family - Detached,1320,1313,7,0.0053030303030303
83.37,2035,Mobile Home,0,0,0,
83.37,2035,Multifamily,0,0,0,
83.37,2035,Single Family - Detached,1325,1320,5,0.00377358490566038
83.37,2040,Mobile Home,0,0,0,
83.37,2040,Multifamily,0,0,0,
83.37,2040,Single Family - Detached,1343,1338,5,0.00372300819061802
83.37,2045,Mobile Home,0,0,0,
83.37,2045,Multifamily,0,0,0,
83.37,2045,Single Family - Detached,1346,1341,5,0.0037147102526003
83.37,2050,Mobile Home,0,0,0,
83.37,2050,Multifamily,0,0,0,
83.37,2050,Single Family - Detached,1346,1341,5,0.0037147102526003
83.39,2012,Mobile Home,0,0,0,
83.39,2012,Multifamily,814,803,11,0.0135135135135135
83.39,2012,Single Family - Detached,44,44,0,0
83.39,2020,Mobile Home,0,0,0,
83.39,2020,Multifamily,933,916,17,0.0182207931404073
83.39,2020,Single Family - Detached,44,44,0,0
83.39,2025,Mobile Home,0,0,0,
83.39,2025,Multifamily,935,926,9,0.00962566844919786
83.39,2025,Single Family - Detached,44,44,0,0
83.39,2030,Mobile Home,0,0,0,
83.39,2030,Multifamily,938,929,9,0.00959488272921109
83.39,2030,Single Family - Detached,44,43,1,0.0227272727272727
83.39,2035,Mobile Home,0,0,0,
83.39,2035,Multifamily,939,933,6,0.00638977635782748
83.39,2035,Single Family - Detached,44,44,0,0
83.39,2040,Mobile Home,0,0,0,
83.39,2040,Multifamily,971,961,10,0.0102986611740474
83.39,2040,Single Family - Detached,44,44,0,0
83.39,2045,Mobile Home,0,0,0,
83.39,2045,Multifamily,1019,985,34,0.0333660451422964
83.39,2045,Single Family - Detached,44,43,1,0.0227272727272727
83.39,2050,Mobile Home,0,0,0,
83.39,2050,Multifamily,1019,983,36,0.0353287536800785
83.39,2050,Single Family - Detached,44,44,0,0
83.40,2012,Mobile Home,0,0,0,
83.40,2012,Multifamily,4419,4084,335,0.0758090065625707
83.40,2012,Single Family - Detached,236,219,17,0.0720338983050847
83.40,2020,Mobile Home,0,0,0,
83.40,2020,Multifamily,4720,4352,368,0.0779661016949153
83.40,2020,Single Family - Detached,237,219,18,0.0759493670886076
83.40,2025,Mobile Home,0,0,0,
83.40,2025,Multifamily,4825,4490,335,0.0694300518134715
83.40,2025,Single Family - Detached,238,223,15,0.0630252100840336
83.40,2030,Mobile Home,0,0,0,
83.40,2030,Multifamily,4839,4500,339,0.0700557966522009
83.40,2030,Single Family - Detached,238,223,15,0.0630252100840336
83.40,2035,Mobile Home,0,0,0,
83.40,2035,Multifamily,4840,4516,324,0.0669421487603306
83.40,2035,Single Family - Detached,238,223,15,0.0630252100840336
83.40,2040,Mobile Home,0,0,0,
83.40,2040,Multifamily,4882,4538,344,0.0704629250307251
83.40,2040,Single Family - Detached,238,223,15,0.0630252100840336
83.40,2045,Mobile Home,0,0,0,
83.40,2045,Multifamily,4933,4590,343,0.0695317251165619
83.40,2045,Single Family - Detached,238,223,15,0.0630252100840336
83.40,2050,Mobile Home,0,0,0,
83.40,2050,Multifamily,4937,4586,351,0.0710958071703464
83.40,2050,Single Family - Detached,238,224,14,0.0588235294117647
83.41,2012,Mobile Home,0,0,0,
83.41,2012,Multifamily,3835,3674,161,0.0419817470664928
83.41,2012,Single Family - Detached,0,0,0,
83.41,2020,Mobile Home,0,0,0,
83.41,2020,Multifamily,4395,4198,197,0.0448236632536974
83.41,2020,Single Family - Detached,0,0,0,
83.41,2025,Mobile Home,0,0,0,
83.41,2025,Multifamily,4395,4222,173,0.0393629124004551
83.41,2025,Single Family - Detached,0,0,0,
83.41,2030,Mobile Home,0,0,0,
83.41,2030,Multifamily,4401,4237,164,0.0372642581231538
83.41,2030,Single Family - Detached,0,0,0,
83.41,2035,Mobile Home,0,0,0,
83.41,2035,Multifamily,4401,4238,163,0.037037037037037
83.41,2035,Single Family - Detached,0,0,0,
83.41,2040,Mobile Home,0,0,0,
83.41,2040,Multifamily,4401,4231,170,0.0386275846398546
83.41,2040,Single Family - Detached,0,0,0,
83.41,2045,Mobile Home,0,0,0,
83.41,2045,Multifamily,4401,4231,170,0.0386275846398546
83.41,2045,Single Family - Detached,0,0,0,
83.41,2050,Mobile Home,0,0,0,
83.41,2050,Multifamily,4401,4231,170,0.0386275846398546
83.41,2050,Single Family - Detached,0,0,0,
83.43,2012,Mobile Home,0,0,0,
83.43,2012,Multifamily,2061,1962,99,0.0480349344978166
83.43,2012,Single Family - Detached,0,0,0,
83.43,2020,Mobile Home,0,0,0,
83.43,2020,Multifamily,2062,1966,96,0.046556741028128
83.43,2020,Single Family - Detached,0,0,0,
83.43,2025,Mobile Home,0,0,0,
83.43,2025,Multifamily,2063,1983,80,0.0387784779447407
83.43,2025,Single Family - Detached,0,0,0,
83.43,2030,Mobile Home,0,0,0,
83.43,2030,Multifamily,2109,2022,87,0.0412517780938834
83.43,2030,Single Family - Detached,0,0,0,
83.43,2035,Mobile Home,0,0,0,
83.43,2035,Multifamily,2109,2027,82,0.0388809862494073
83.43,2035,Single Family - Detached,0,0,0,
83.43,2040,Mobile Home,0,0,0,
83.43,2040,Multifamily,2109,2020,89,0.0422000948316738
83.43,2040,Single Family - Detached,0,0,0,
83.43,2045,Mobile Home,0,0,0,
83.43,2045,Multifamily,2109,2018,91,0.0431484115694642
83.43,2045,Single Family - Detached,0,0,0,
83.43,2050,Mobile Home,0,0,0,
83.43,2050,Multifamily,2109,2016,93,0.0440967283072546
83.43,2050,Single Family - Detached,0,0,0,
83.44,2012,Mobile Home,0,0,0,
83.44,2012,Multifamily,75,75,0,0
83.44,2012,Single Family - Detached,1208,1179,29,0.0240066225165563
83.44,2020,Mobile Home,0,0,0,
83.44,2020,Multifamily,76,74,2,0.0263157894736842
83.44,2020,Single Family - Detached,1208,1178,30,0.0248344370860927
83.44,2025,Mobile Home,0,0,0,
83.44,2025,Multifamily,108,107,1,0.00925925925925926
83.44,2025,Single Family - Detached,1208,1181,27,0.0223509933774834
83.44,2030,Mobile Home,0,0,0,
83.44,2030,Multifamily,108,107,1,0.00925925925925926
83.44,2030,Single Family - Detached,1208,1181,27,0.0223509933774834
83.44,2035,Mobile Home,0,0,0,
83.44,2035,Multifamily,108,107,1,0.00925925925925926
83.44,2035,Single Family - Detached,1208,1182,26,0.021523178807947
83.44,2040,Mobile Home,0,0,0,
83.44,2040,Multifamily,108,107,1,0.00925925925925926
83.44,2040,Single Family - Detached,1208,1181,27,0.0223509933774834
83.44,2045,Mobile Home,0,0,0,
83.44,2045,Multifamily,108,107,1,0.00925925925925926
83.44,2045,Single Family - Detached,1208,1180,28,0.0231788079470199
83.44,2050,Mobile Home,0,0,0,
83.44,2050,Multifamily,108,107,1,0.00925925925925926
83.44,2050,Single Family - Detached,1208,1180,28,0.0231788079470199
83.45,2012,Mobile Home,0,0,0,
83.45,2012,Multifamily,874,859,15,0.017162471395881
83.45,2012,Single Family - Detached,798,779,19,0.0238095238095238
83.45,2020,Mobile Home,0,0,0,
83.45,2020,Multifamily,1973,1953,20,0.010136847440446
83.45,2020,Single Family - Detached,798,775,23,0.0288220551378446
83.45,2025,Mobile Home,0,0,0,
83.45,2025,Multifamily,1973,1954,19,0.00963000506842372
83.45,2025,Single Family - Detached,798,779,19,0.0238095238095238
83.45,2030,Mobile Home,0,0,0,
83.45,2030,Multifamily,1973,1954,19,0.00963000506842372
83.45,2030,Single Family - Detached,798,777,21,0.0263157894736842
83.45,2035,Mobile Home,0,0,0,
83.45,2035,Multifamily,1973,1954,19,0.00963000506842372
83.45,2035,Single Family - Detached,798,779,19,0.0238095238095238
83.45,2040,Mobile Home,0,0,0,
83.45,2040,Multifamily,1973,1953,20,0.010136847440446
83.45,2040,Single Family - Detached,798,776,22,0.0275689223057644
83.45,2045,Mobile Home,0,0,0,
83.45,2045,Multifamily,1973,1953,20,0.010136847440446
83.45,2045,Single Family - Detached,798,772,26,0.0325814536340852
83.45,2050,Mobile Home,0,0,0,
83.45,2050,Multifamily,1973,1953,20,0.010136847440446
83.45,2050,Single Family - Detached,798,770,28,0.0350877192982456
83.46,2012,Mobile Home,0,0,0,
83.46,2012,Multifamily,376,374,2,0.00531914893617021
83.46,2012,Single Family - Detached,1239,1201,38,0.0306698950766747
83.46,2020,Mobile Home,0,0,0,
83.46,2020,Multifamily,437,437,0,0
83.46,2020,Single Family - Detached,1285,1245,40,0.0311284046692607
83.46,2025,Mobile Home,0,0,0,
83.46,2025,Multifamily,472,472,0,0
83.46,2025,Single Family - Detached,1288,1250,38,0.0295031055900621
83.46,2030,Mobile Home,0,0,0,
83.46,2030,Multifamily,520,520,0,0
83.46,2030,Single Family - Detached,1290,1252,38,0.0294573643410853
83.46,2035,Mobile Home,0,0,0,
83.46,2035,Multifamily,520,520,0,0
83.46,2035,Single Family - Detached,1300,1263,37,0.0284615384615385
83.46,2040,Mobile Home,0,0,0,
83.46,2040,Multifamily,520,517,3,0.00576923076923077
83.46,2040,Single Family - Detached,1301,1264,37,0.0284396617986164
83.46,2045,Mobile Home,0,0,0,
83.46,2045,Multifamily,520,516,4,0.00769230769230769
83.46,2045,Single Family - Detached,1301,1264,37,0.0284396617986164
83.46,2050,Mobile Home,0,0,0,
83.46,2050,Multifamily,520,515,5,0.00961538461538462
83.46,2050,Single Family - Detached,1301,1264,37,0.0284396617986164
83.47,2012,Mobile Home,0,0,0,
83.47,2012,Multifamily,292,292,0,0
83.47,2012,Single Family - Detached,1735,1697,38,0.0219020172910663
83.47,2020,Mobile Home,0,0,0,
83.47,2020,Multifamily,292,292,0,0
83.47,2020,Single Family - Detached,1863,1820,43,0.0230810520665593
83.47,2025,Mobile Home,0,0,0,
83.47,2025,Multifamily,292,292,0,0
83.47,2025,Single Family - Detached,1863,1828,35,0.0187869028448739
83.47,2030,Mobile Home,0,0,0,
83.47,2030,Multifamily,292,292,0,0
83.47,2030,Single Family - Detached,1863,1828,35,0.0187869028448739
83.47,2035,Mobile Home,0,0,0,
83.47,2035,Multifamily,292,292,0,0
83.47,2035,Single Family - Detached,1863,1832,31,0.0166398282340311
83.47,2040,Mobile Home,0,0,0,
83.47,2040,Multifamily,292,292,0,0
83.47,2040,Single Family - Detached,1863,1830,33,0.0177133655394525
83.47,2045,Mobile Home,0,0,0,
83.47,2045,Multifamily,292,292,0,0
83.47,2045,Single Family - Detached,1863,1830,33,0.0177133655394525
83.47,2050,Mobile Home,0,0,0,
83.47,2050,Multifamily,292,292,0,0
83.47,2050,Single Family - Detached,1863,1830,33,0.0177133655394525
83.48,2012,Mobile Home,0,0,0,
83.48,2012,Multifamily,544,544,0,0
83.48,2012,Single Family - Detached,1264,1229,35,0.0276898734177215
83.48,2020,Mobile Home,0,0,0,
83.48,2020,Multifamily,544,544,0,0
83.48,2020,Single Family - Detached,1264,1218,46,0.0363924050632911
83.48,2025,Mobile Home,0,0,0,
83.48,2025,Multifamily,544,544,0,0
83.48,2025,Single Family - Detached,1264,1234,30,0.0237341772151899
83.48,2030,Mobile Home,0,0,0,
83.48,2030,Multifamily,544,544,0,0
83.48,2030,Single Family - Detached,1264,1232,32,0.0253164556962025
83.48,2035,Mobile Home,0,0,0,
83.48,2035,Multifamily,544,544,0,0
83.48,2035,Single Family - Detached,1264,1237,27,0.0213607594936709
83.48,2040,Mobile Home,0,0,0,
83.48,2040,Multifamily,544,544,0,0
83.48,2040,Single Family - Detached,1264,1226,38,0.0300632911392405
83.48,2045,Mobile Home,0,0,0,
83.48,2045,Multifamily,544,544,0,0
83.48,2045,Single Family - Detached,1264,1221,43,0.0340189873417722
83.48,2050,Mobile Home,0,0,0,
83.48,2050,Multifamily,544,544,0,0
83.48,2050,Single Family - Detached,1264,1221,43,0.0340189873417722
83.49,2012,Mobile Home,0,0,0,
83.49,2012,Multifamily,133,127,6,0.0451127819548872
83.49,2012,Single Family - Detached,950,938,12,0.0126315789473684
83.49,2020,Mobile Home,0,0,0,
83.49,2020,Multifamily,133,130,3,0.0225563909774436
83.49,2020,Single Family - Detached,950,937,13,0.0136842105263158
83.49,2025,Mobile Home,0,0,0,
83.49,2025,Multifamily,133,132,1,0.0075187969924812
83.49,2025,Single Family - Detached,950,942,8,0.00842105263157895
83.49,2030,Mobile Home,0,0,0,
83.49,2030,Multifamily,133,132,1,0.0075187969924812
83.49,2030,Single Family - Detached,950,942,8,0.00842105263157895
83.49,2035,Mobile Home,0,0,0,
83.49,2035,Multifamily,133,133,0,0
83.49,2035,Single Family - Detached,950,943,7,0.00736842105263158
83.49,2040,Mobile Home,0,0,0,
83.49,2040,Multifamily,133,133,0,0
83.49,2040,Single Family - Detached,950,942,8,0.00842105263157895
83.49,2045,Mobile Home,0,0,0,
83.49,2045,Multifamily,133,133,0,0
83.49,2045,Single Family - Detached,950,942,8,0.00842105263157895
83.49,2050,Mobile Home,0,0,0,
83.49,2050,Multifamily,133,133,0,0
83.49,2050,Single Family - Detached,950,942,8,0.00842105263157895
83.50,2012,Mobile Home,0,0,0,
83.50,2012,Multifamily,901,845,56,0.0621531631520533
83.50,2012,Single Family - Detached,1320,1309,11,0.00833333333333333
83.50,2020,Mobile Home,0,0,0,
83.50,2020,Multifamily,2899,2750,149,0.0513970334598137
83.50,2020,Single Family - Detached,1321,1305,16,0.012112036336109
83.50,2025,Mobile Home,0,0,0,
83.50,2025,Multifamily,3588,3433,155,0.0431995540691193
83.50,2025,Single Family - Detached,1321,1308,13,0.00984102952308857
83.50,2030,Mobile Home,0,0,0,
83.50,2030,Multifamily,4590,4395,195,0.042483660130719
83.50,2030,Single Family - Detached,1321,1308,13,0.00984102952308857
83.50,2035,Mobile Home,0,0,0,
83.50,2035,Multifamily,5330,5121,209,0.0392120075046904
83.50,2035,Single Family - Detached,1321,1309,12,0.00908402725208176
83.50,2040,Mobile Home,0,0,0,
83.50,2040,Multifamily,5335,5108,227,0.0425492033739456
83.50,2040,Single Family - Detached,1321,1306,15,0.0113550340651022
83.50,2045,Mobile Home,0,0,0,
83.50,2045,Multifamily,5335,5106,229,0.0429240862230553
83.50,2045,Single Family - Detached,1321,1304,17,0.0128690386071158
83.50,2050,Mobile Home,0,0,0,
83.50,2050,Multifamily,5335,5095,240,0.0449859418931584
83.50,2050,Single Family - Detached,1321,1304,17,0.0128690386071158
83.51,2012,Mobile Home,0,0,0,
83.51,2012,Multifamily,301,300,1,0.00332225913621262
83.51,2012,Single Family - Detached,1069,1029,40,0.0374181478016838
83.51,2020,Mobile Home,0,0,0,
83.51,2020,Multifamily,312,311,1,0.00320512820512821
83.51,2020,Single Family - Detached,1069,1028,41,0.0383536014967259
83.51,2025,Mobile Home,0,0,0,
83.51,2025,Multifamily,354,351,3,0.00847457627118644
83.51,2025,Single Family - Detached,1069,1028,41,0.0383536014967259
83.51,2030,Mobile Home,0,0,0,
83.51,2030,Multifamily,417,408,9,0.0215827338129496
83.51,2030,Single Family - Detached,1069,1028,41,0.0383536014967259
83.51,2035,Mobile Home,0,0,0,
83.51,2035,Multifamily,457,445,12,0.0262582056892779
83.51,2035,Single Family - Detached,1069,1029,40,0.0374181478016838
83.51,2040,Mobile Home,0,0,0,
83.51,2040,Multifamily,457,441,16,0.0350109409190372
83.51,2040,Single Family - Detached,1069,1029,40,0.0374181478016838
83.51,2045,Mobile Home,0,0,0,
83.51,2045,Multifamily,457,440,17,0.037199124726477
83.51,2045,Single Family - Detached,1069,1029,40,0.0374181478016838
83.51,2050,Mobile Home,0,0,0,
83.51,2050,Multifamily,458,445,13,0.0283842794759825
83.51,2050,Single Family - Detached,1069,1029,40,0.0374181478016838
83.52,2012,Mobile Home,0,0,0,
83.52,2012,Multifamily,444,444,0,0
83.52,2012,Single Family - Detached,685,654,31,0.0452554744525547
83.52,2020,Mobile Home,0,0,0,
83.52,2020,Multifamily,445,445,0,0
83.52,2020,Single Family - Detached,685,654,31,0.0452554744525547
83.52,2025,Mobile Home,0,0,0,
83.52,2025,Multifamily,446,444,2,0.00448430493273543
83.52,2025,Single Family - Detached,685,655,30,0.0437956204379562
83.52,2030,Mobile Home,0,0,0,
83.52,2030,Multifamily,446,444,2,0.00448430493273543
83.52,2030,Single Family - Detached,685,655,30,0.0437956204379562
83.52,2035,Mobile Home,0,0,0,
83.52,2035,Multifamily,446,445,1,0.00224215246636771
83.52,2035,Single Family - Detached,685,655,30,0.0437956204379562
83.52,2040,Mobile Home,0,0,0,
83.52,2040,Multifamily,446,442,4,0.00896860986547085
83.52,2040,Single Family - Detached,685,654,31,0.0452554744525547
83.52,2045,Mobile Home,0,0,0,
83.52,2045,Multifamily,446,442,4,0.00896860986547085
83.52,2045,Single Family - Detached,685,654,31,0.0452554744525547
83.52,2050,Mobile Home,0,0,0,
83.52,2050,Multifamily,446,442,4,0.00896860986547085
83.52,2050,Single Family - Detached,685,654,31,0.0452554744525547
83.53,2012,Mobile Home,0,0,0,
83.53,2012,Multifamily,51,51,0,0
83.53,2012,Single Family - Detached,1512,1504,8,0.00529100529100529
83.53,2020,Mobile Home,0,0,0,
83.53,2020,Multifamily,51,51,0,0
83.53,2020,Single Family - Detached,1512,1502,10,0.00661375661375661
83.53,2025,Mobile Home,0,0,0,
83.53,2025,Multifamily,51,50,1,0.0196078431372549
83.53,2025,Single Family - Detached,1512,1504,8,0.00529100529100529
83.53,2030,Mobile Home,0,0,0,
83.53,2030,Multifamily,51,50,1,0.0196078431372549
83.53,2030,Single Family - Detached,1512,1504,8,0.00529100529100529
83.53,2035,Mobile Home,0,0,0,
83.53,2035,Multifamily,51,51,0,0
83.53,2035,Single Family - Detached,1512,1505,7,0.00462962962962963
83.53,2040,Mobile Home,0,0,0,
83.53,2040,Multifamily,51,50,1,0.0196078431372549
83.53,2040,Single Family - Detached,1512,1503,9,0.00595238095238095
83.53,2045,Mobile Home,0,0,0,
83.53,2045,Multifamily,51,49,2,0.0392156862745098
83.53,2045,Single Family - Detached,1512,1501,11,0.00727513227513227
83.53,2050,Mobile Home,0,0,0,
83.53,2050,Multifamily,51,48,3,0.0588235294117647
83.53,2050,Single Family - Detached,1512,1501,11,0.00727513227513227
83.54,2012,Mobile Home,0,0,0,
83.54,2012,Multifamily,837,807,30,0.03584229390681
83.54,2012,Single Family - Detached,1258,1226,32,0.0254372019077901
83.54,2020,Mobile Home,0,0,0,
83.54,2020,Multifamily,3037,2949,88,0.0289759631215015
83.54,2020,Single Family - Detached,1258,1226,32,0.0254372019077901
83.54,2025,Mobile Home,0,0,0,
83.54,2025,Multifamily,3043,2979,64,0.0210318764377259
83.54,2025,Single Family - Detached,1258,1226,32,0.0254372019077901
83.54,2030,Mobile Home,0,0,0,
83.54,2030,Multifamily,3043,2979,64,0.0210318764377259
83.54,2030,Single Family - Detached,1258,1226,32,0.0254372019077901
83.54,2035,Mobile Home,0,0,0,
83.54,2035,Multifamily,3043,2980,63,0.0207032533683865
83.54,2035,Single Family - Detached,1258,1226,32,0.0254372019077901
83.54,2040,Mobile Home,0,0,0,
83.54,2040,Multifamily,3043,2978,65,0.0213604995070654
83.54,2040,Single Family - Detached,1258,1226,32,0.0254372019077901
83.54,2045,Mobile Home,0,0,0,
83.54,2045,Multifamily,3043,2978,65,0.0213604995070654
83.54,2045,Single Family - Detached,1258,1226,32,0.0254372019077901
83.54,2050,Mobile Home,0,0,0,
83.54,2050,Multifamily,3043,2978,65,0.0213604995070654
83.54,2050,Single Family - Detached,1258,1226,32,0.0254372019077901
83.55,2012,Mobile Home,0,0,0,
83.55,2012,Multifamily,0,0,0,
83.55,2012,Single Family - Detached,960,948,12,0.0125
83.55,2020,Mobile Home,0,0,0,
83.55,2020,Multifamily,0,0,0,
83.55,2020,Single Family - Detached,960,945,15,0.015625
83.55,2025,Mobile Home,0,0,0,
83.55,2025,Multifamily,0,0,0,
83.55,2025,Single Family - Detached,960,948,12,0.0125
83.55,2030,Mobile Home,0,0,0,
83.55,2030,Multifamily,0,0,0,
83.55,2030,Single Family - Detached,960,948,12,0.0125
83.55,2035,Mobile Home,0,0,0,
83.55,2035,Multifamily,0,0,0,
83.55,2035,Single Family - Detached,960,948,12,0.0125
83.55,2040,Mobile Home,0,0,0,
83.55,2040,Multifamily,0,0,0,
83.55,2040,Single Family - Detached,960,945,15,0.015625
83.55,2045,Mobile Home,0,0,0,
83.55,2045,Multifamily,0,0,0,
83.55,2045,Single Family - Detached,960,942,18,0.01875
83.55,2050,Mobile Home,0,0,0,
83.55,2050,Multifamily,0,0,0,
83.55,2050,Single Family - Detached,960,942,18,0.01875
83.56,2012,Mobile Home,0,0,0,
83.56,2012,Multifamily,732,707,25,0.0341530054644809
83.56,2012,Single Family - Detached,632,620,12,0.0189873417721519
83.56,2020,Mobile Home,0,0,0,
83.56,2020,Multifamily,732,707,25,0.0341530054644809
83.56,2020,Single Family - Detached,632,620,12,0.0189873417721519
83.56,2025,Mobile Home,0,0,0,
83.56,2025,Multifamily,732,707,25,0.0341530054644809
83.56,2025,Single Family - Detached,632,620,12,0.0189873417721519
83.56,2030,Mobile Home,0,0,0,
83.56,2030,Multifamily,732,707,25,0.0341530054644809
83.56,2030,Single Family - Detached,632,620,12,0.0189873417721519
83.56,2035,Mobile Home,0,0,0,
83.56,2035,Multifamily,732,707,25,0.0341530054644809
83.56,2035,Single Family - Detached,632,621,11,0.0174050632911392
83.56,2040,Mobile Home,0,0,0,
83.56,2040,Multifamily,732,705,27,0.0368852459016393
83.56,2040,Single Family - Detached,632,620,12,0.0189873417721519
83.56,2045,Mobile Home,0,0,0,
83.56,2045,Multifamily,732,705,27,0.0368852459016393
83.56,2045,Single Family - Detached,632,620,12,0.0189873417721519
83.56,2050,Mobile Home,0,0,0,
83.56,2050,Multifamily,732,705,27,0.0368852459016393
83.56,2050,Single Family - Detached,632,620,12,0.0189873417721519
83.57,2012,Mobile Home,0,0,0,
83.57,2012,Multifamily,707,689,18,0.0254596888260255
83.57,2012,Single Family - Detached,792,775,17,0.0214646464646465
83.57,2020,Mobile Home,0,0,0,
83.57,2020,Multifamily,707,688,19,0.0268741159830269
83.57,2020,Single Family - Detached,792,775,17,0.0214646464646465
83.57,2025,Mobile Home,0,0,0,
83.57,2025,Multifamily,707,686,21,0.0297029702970297
83.57,2025,Single Family - Detached,792,776,16,0.0202020202020202
83.57,2030,Mobile Home,0,0,0,
83.57,2030,Multifamily,707,686,21,0.0297029702970297
83.57,2030,Single Family - Detached,792,776,16,0.0202020202020202
83.57,2035,Mobile Home,0,0,0,
83.57,2035,Multifamily,707,688,19,0.0268741159830269
83.57,2035,Single Family - Detached,792,778,14,0.0176767676767677
83.57,2040,Mobile Home,0,0,0,
83.57,2040,Multifamily,707,685,22,0.0311173974540311
83.57,2040,Single Family - Detached,792,777,15,0.0189393939393939
83.57,2045,Mobile Home,0,0,0,
83.57,2045,Multifamily,707,683,24,0.0339462517680339
83.57,2045,Single Family - Detached,792,777,15,0.0189393939393939
83.57,2050,Mobile Home,0,0,0,
83.57,2050,Multifamily,707,681,26,0.0367751060820368
83.57,2050,Single Family - Detached,792,777,15,0.0189393939393939
83.58,2012,Mobile Home,161,147,14,0.0869565217391304
83.58,2012,Multifamily,365,363,2,0.00547945205479452
83.58,2012,Single Family - Detached,1697,1630,67,0.0394814378314673
83.58,2020,Mobile Home,161,147,14,0.0869565217391304
83.58,2020,Multifamily,482,479,3,0.00622406639004149
83.58,2020,Single Family - Detached,1697,1629,68,0.0400707130229817
83.58,2025,Mobile Home,161,147,14,0.0869565217391304
83.58,2025,Multifamily,513,499,14,0.0272904483430799
83.58,2025,Single Family - Detached,1697,1630,67,0.0394814378314673
83.58,2030,Mobile Home,119,93,26,0.218487394957983
83.58,2030,Multifamily,592,573,19,0.0320945945945946
83.58,2030,Single Family - Detached,1697,1630,67,0.0394814378314673
83.58,2035,Mobile Home,80,64,16,0.2
83.58,2035,Multifamily,665,652,13,0.0195488721804511
83.58,2035,Single Family - Detached,1697,1630,67,0.0394814378314673
83.58,2040,Mobile Home,30,24,6,0.2
83.58,2040,Multifamily,757,736,21,0.0277410832232497
83.58,2040,Single Family - Detached,1697,1628,69,0.0406599882144962
83.58,2045,Mobile Home,0,0,0,
83.58,2045,Multifamily,812,787,25,0.0307881773399015
83.58,2045,Single Family - Detached,1697,1627,70,0.0412492634060106
83.58,2050,Mobile Home,0,0,0,
83.58,2050,Multifamily,812,785,27,0.0332512315270936
83.58,2050,Single Family - Detached,1697,1627,70,0.0412492634060106
83.59,2012,Mobile Home,125,78,47,0.376
83.59,2012,Multifamily,1705,1668,37,0.0217008797653959
83.59,2012,Single Family - Detached,0,0,0,
83.59,2020,Mobile Home,125,79,46,0.368
83.59,2020,Multifamily,1705,1668,37,0.0217008797653959
83.59,2020,Single Family - Detached,0,0,0,
83.59,2025,Mobile Home,125,79,46,0.368
83.59,2025,Multifamily,1832,1811,21,0.0114628820960699
83.59,2025,Single Family - Detached,0,0,0,
83.59,2030,Mobile Home,0,0,0,
83.59,2030,Multifamily,2171,2147,24,0.011054813450023
83.59,2030,Single Family - Detached,0,0,0,
83.59,2035,Mobile Home,0,0,0,
83.59,2035,Multifamily,2189,2166,23,0.0105070808588397
83.59,2035,Single Family - Detached,0,0,0,
83.59,2040,Mobile Home,0,0,0,
83.59,2040,Multifamily,2212,2184,28,0.0126582278481013
83.59,2040,Single Family - Detached,0,0,0,
83.59,2045,Mobile Home,0,0,0,
83.59,2045,Multifamily,2226,2196,30,0.0134770889487871
83.59,2045,Single Family - Detached,0,0,0,
83.59,2050,Mobile Home,0,0,0,
83.59,2050,Multifamily,2226,2195,31,0.01392632524708
83.59,2050,Single Family - Detached,0,0,0,
83.60,2012,Mobile Home,0,0,0,
83.60,2012,Multifamily,1039,1025,14,0.0134744947064485
83.60,2012,Single Family - Detached,1146,1079,67,0.0584642233856894
83.60,2020,Mobile Home,0,0,0,
83.60,2020,Multifamily,1775,1750,25,0.0140845070422535
83.60,2020,Single Family - Detached,1146,1079,67,0.0584642233856894
83.60,2025,Mobile Home,0,0,0,
83.60,2025,Multifamily,2750,2717,33,0.012
83.60,2025,Single Family - Detached,1146,1081,65,0.0567190226876091
83.60,2030,Mobile Home,0,0,0,
83.60,2030,Multifamily,2964,2930,34,0.0114709851551957
83.60,2030,Single Family - Detached,1146,1081,65,0.0567190226876091
83.60,2035,Mobile Home,0,0,0,
83.60,2035,Multifamily,2964,2930,34,0.0114709851551957
83.60,2035,Single Family - Detached,1146,1083,63,0.0549738219895288
83.60,2040,Mobile Home,0,0,0,
83.60,2040,Multifamily,2964,2927,37,0.0124831309041835
83.60,2040,Single Family - Detached,1146,1081,65,0.0567190226876091
83.60,2045,Mobile Home,0,0,0,
83.60,2045,Multifamily,2964,2925,39,0.0131578947368421
83.60,2045,Single Family - Detached,1146,1080,66,0.0575916230366492
83.60,2050,Mobile Home,0,0,0,
83.60,2050,Multifamily,2964,2925,39,0.0131578947368421
83.60,2050,Single Family - Detached,1146,1080,66,0.0575916230366492
83.61,2012,Mobile Home,0,0,0,
83.61,2012,Multifamily,1523,1438,85,0.0558108995403808
83.61,2012,Single Family - Detached,0,0,0,
83.61,2020,Mobile Home,0,0,0,
83.61,2020,Multifamily,1523,1442,81,0.0531845042678923
83.61,2020,Single Family - Detached,0,0,0,
83.61,2025,Mobile Home,0,0,0,
83.61,2025,Multifamily,1527,1458,69,0.0451866404715128
83.61,2025,Single Family - Detached,0,0,0,
83.61,2030,Mobile Home,0,0,0,
83.61,2030,Multifamily,1603,1532,71,0.0442919525888958
83.61,2030,Single Family - Detached,0,0,0,
83.61,2035,Mobile Home,0,0,0,
83.61,2035,Multifamily,1650,1581,69,0.0418181818181818
83.61,2035,Single Family - Detached,0,0,0,
83.61,2040,Mobile Home,0,0,0,
83.61,2040,Multifamily,1652,1577,75,0.0453995157384988
83.61,2040,Single Family - Detached,0,0,0,
83.61,2045,Mobile Home,0,0,0,
83.61,2045,Multifamily,1652,1576,76,0.0460048426150121
83.61,2045,Single Family - Detached,0,0,0,
83.61,2050,Mobile Home,0,0,0,
83.61,2050,Multifamily,1652,1575,77,0.0466101694915254
83.61,2050,Single Family - Detached,0,0,0,
83.62,2012,Mobile Home,0,0,0,
83.62,2012,Multifamily,1736,1595,141,0.081221198156682
83.62,2012,Single Family - Detached,0,0,0,
83.62,2020,Mobile Home,0,0,0,
83.62,2020,Multifamily,1736,1597,139,0.0800691244239631
83.62,2020,Single Family - Detached,0,0,0,
83.62,2025,Mobile Home,0,0,0,
83.62,2025,Multifamily,1738,1614,124,0.0713463751438435
83.62,2025,Single Family - Detached,0,0,0,
83.62,2030,Mobile Home,0,0,0,
83.62,2030,Multifamily,1738,1609,129,0.0742232451093211
83.62,2030,Single Family - Detached,0,0,0,
83.62,2035,Mobile Home,0,0,0,
83.62,2035,Multifamily,1738,1615,123,0.070771001150748
83.62,2035,Single Family - Detached,0,0,0,
83.62,2040,Mobile Home,0,0,0,
83.62,2040,Multifamily,1738,1608,130,0.0747986191024166
83.62,2040,Single Family - Detached,0,0,0,
83.62,2045,Mobile Home,0,0,0,
83.62,2045,Multifamily,1738,1607,131,0.0753739930955121
83.62,2045,Single Family - Detached,0,0,0,
83.62,2050,Mobile Home,0,0,0,
83.62,2050,Multifamily,1738,1606,132,0.0759493670886076
83.62,2050,Single Family - Detached,0,0,0,
83.63,2012,Mobile Home,0,0,0,
83.63,2012,Multifamily,2310,2190,120,0.051948051948052
83.63,2012,Single Family - Detached,0,0,0,
83.63,2020,Mobile Home,0,0,0,
83.63,2020,Multifamily,2310,2187,123,0.0532467532467532
83.63,2020,Single Family - Detached,0,0,0,
83.63,2025,Mobile Home,0,0,0,
83.63,2025,Multifamily,2310,2197,113,0.0489177489177489
83.63,2025,Single Family - Detached,0,0,0,
83.63,2030,Mobile Home,0,0,0,
83.63,2030,Multifamily,2310,2195,115,0.0497835497835498
83.63,2030,Single Family - Detached,0,0,0,
83.63,2035,Mobile Home,0,0,0,
83.63,2035,Multifamily,2310,2195,115,0.0497835497835498
83.63,2035,Single Family - Detached,0,0,0,
83.63,2040,Mobile Home,0,0,0,
83.63,2040,Multifamily,2310,2193,117,0.0506493506493507
83.63,2040,Single Family - Detached,0,0,0,
83.63,2045,Mobile Home,0,0,0,
83.63,2045,Multifamily,2310,2193,117,0.0506493506493507
83.63,2045,Single Family - Detached,0,0,0,
83.63,2050,Mobile Home,0,0,0,
83.63,2050,Multifamily,2310,2193,117,0.0506493506493507
83.63,2050,Single Family - Detached,0,0,0,
83.64,2012,Mobile Home,0,0,0,
83.64,2012,Multifamily,2525,2380,145,0.0574257425742574
83.64,2012,Single Family - Detached,323,261,62,0.191950464396285
83.64,2020,Mobile Home,0,0,0,
83.64,2020,Multifamily,2525,2367,158,0.0625742574257426
83.64,2020,Single Family - Detached,323,261,62,0.191950464396285
83.64,2025,Mobile Home,0,0,0,
83.64,2025,Multifamily,2525,2393,132,0.0522772277227723
83.64,2025,Single Family - Detached,323,261,62,0.191950464396285
83.64,2030,Mobile Home,0,0,0,
83.64,2030,Multifamily,2525,2384,141,0.0558415841584158
83.64,2030,Single Family - Detached,323,261,62,0.191950464396285
83.64,2035,Mobile Home,0,0,0,
83.64,2035,Multifamily,2525,2389,136,0.0538613861386139
83.64,2035,Single Family - Detached,323,261,62,0.191950464396285
83.64,2040,Mobile Home,0,0,0,
83.64,2040,Multifamily,2525,2380,145,0.0574257425742574
83.64,2040,Single Family - Detached,323,261,62,0.191950464396285
83.64,2045,Mobile Home,0,0,0,
83.64,2045,Multifamily,2525,2376,149,0.059009900990099
83.64,2045,Single Family - Detached,323,261,62,0.191950464396285
83.64,2050,Mobile Home,0,0,0,
83.64,2050,Multifamily,2525,2372,153,0.0605940594059406
83.64,2050,Single Family - Detached,323,262,61,0.188854489164087
83.65,2012,Mobile Home,0,0,0,
83.65,2012,Multifamily,0,0,0,
83.65,2012,Single Family - Detached,933,909,24,0.0257234726688103
83.65,2020,Mobile Home,0,0,0,
83.65,2020,Multifamily,0,0,0,
83.65,2020,Single Family - Detached,933,909,24,0.0257234726688103
83.65,2025,Mobile Home,0,0,0,
83.65,2025,Multifamily,0,0,0,
83.65,2025,Single Family - Detached,933,913,20,0.0214362272240086
83.65,2030,Mobile Home,0,0,0,
83.65,2030,Multifamily,0,0,0,
83.65,2030,Single Family - Detached,933,913,20,0.0214362272240086
83.65,2035,Mobile Home,0,0,0,
83.65,2035,Multifamily,0,0,0,
83.65,2035,Single Family - Detached,933,915,18,0.0192926045016077
83.65,2040,Mobile Home,0,0,0,
83.65,2040,Multifamily,0,0,0,
83.65,2040,Single Family - Detached,933,915,18,0.0192926045016077
83.65,2045,Mobile Home,0,0,0,
83.65,2045,Multifamily,0,0,0,
83.65,2045,Single Family - Detached,933,915,18,0.0192926045016077
83.65,2050,Mobile Home,0,0,0,
83.65,2050,Multifamily,0,0,0,
83.65,2050,Single Family - Detached,933,915,18,0.0192926045016077
83.66,2012,Mobile Home,0,0,0,
83.66,2012,Multifamily,26,26,0,0
83.66,2012,Single Family - Detached,2137,2137,0,0
83.66,2020,Mobile Home,0,0,0,
83.66,2020,Multifamily,610,610,0,0
83.66,2020,Single Family - Detached,2215,2212,3,0.00135440180586907
83.66,2025,Mobile Home,0,0,0,
83.66,2025,Multifamily,610,610,0,0
83.66,2025,Single Family - Detached,2237,2236,1,0.000447027268663388
83.66,2030,Mobile Home,0,0,0,
83.66,2030,Multifamily,610,610,0,0
83.66,2030,Single Family - Detached,2258,2256,2,0.000885739592559787
83.66,2035,Mobile Home,0,0,0,
83.66,2035,Multifamily,610,610,0,0
83.66,2035,Single Family - Detached,2259,2259,0,0
83.66,2040,Mobile Home,0,0,0,
83.66,2040,Multifamily,610,609,1,0.00163934426229508
83.66,2040,Single Family - Detached,2277,2275,2,0.000878348704435661
83.66,2045,Mobile Home,0,0,0,
83.66,2045,Multifamily,610,609,1,0.00163934426229508
83.66,2045,Single Family - Detached,2285,2281,4,0.00175054704595186
83.66,2050,Mobile Home,0,0,0,
83.66,2050,Multifamily,610,609,1,0.00163934426229508
83.66,2050,Single Family - Detached,2295,2292,3,0.00130718954248366
85.01,2012,Mobile Home,120,120,0,0
85.01,2012,Multifamily,195,195,0,0
85.01,2012,Single Family - Detached,1957,1814,143,0.0730710270822688
85.01,2020,Mobile Home,120,120,0,0
85.01,2020,Multifamily,195,189,6,0.0307692307692308
85.01,2020,Single Family - Detached,1957,1810,147,0.0751149718957588
85.01,2025,Mobile Home,120,120,0,0
85.01,2025,Multifamily,195,190,5,0.0256410256410256
85.01,2025,Single Family - Detached,1957,1823,134,0.0684721512519162
85.01,2030,Mobile Home,120,119,1,0.00833333333333333
85.01,2030,Multifamily,195,190,5,0.0256410256410256
85.01,2030,Single Family - Detached,1957,1822,135,0.0689831374552887
85.01,2035,Mobile Home,120,119,1,0.00833333333333333
85.01,2035,Multifamily,195,190,5,0.0256410256410256
85.01,2035,Single Family - Detached,1957,1825,132,0.0674501788451712
85.01,2040,Mobile Home,120,119,1,0.00833333333333333
85.01,2040,Multifamily,195,188,7,0.0358974358974359
85.01,2040,Single Family - Detached,1957,1821,136,0.0694941236586612
85.01,2045,Mobile Home,120,118,2,0.0166666666666667
85.01,2045,Multifamily,195,171,24,0.123076923076923
85.01,2045,Single Family - Detached,1957,1820,137,0.0700051098620337
85.01,2050,Mobile Home,120,116,4,0.0333333333333333
85.01,2050,Multifamily,196,169,27,0.137755102040816
85.01,2050,Single Family - Detached,1969,1830,139,0.0705942102590147
85.02,2012,Mobile Home,0,0,0,
85.02,2012,Multifamily,213,196,17,0.07981220657277
85.02,2012,Single Family - Detached,2191,2152,39,0.0178000912825194
85.02,2020,Mobile Home,0,0,0,
85.02,2020,Multifamily,218,210,8,0.036697247706422
85.02,2020,Single Family - Detached,2202,2154,48,0.0217983651226158
85.02,2025,Mobile Home,0,0,0,
85.02,2025,Multifamily,290,284,6,0.0206896551724138
85.02,2025,Single Family - Detached,2202,2172,30,0.0136239782016349
85.02,2030,Mobile Home,0,0,0,
85.02,2030,Multifamily,292,286,6,0.0205479452054795
85.02,2030,Single Family - Detached,2267,2236,31,0.0136744596382885
85.02,2035,Mobile Home,0,0,0,
85.02,2035,Multifamily,293,289,4,0.0136518771331058
85.02,2035,Single Family - Detached,2338,2313,25,0.0106928999144568
85.02,2040,Mobile Home,0,0,0,
85.02,2040,Multifamily,1334,1231,103,0.0772113943028486
85.02,2040,Single Family - Detached,2371,2338,33,0.013918177983973
85.02,2045,Mobile Home,0,0,0,
85.02,2045,Multifamily,1642,1596,46,0.0280146163215591
85.02,2045,Single Family - Detached,2371,2335,36,0.0151834668916069
85.02,2050,Mobile Home,0,0,0,
85.02,2050,Multifamily,1656,1614,42,0.0253623188405797
85.02,2050,Single Family - Detached,2377,2339,38,0.0159865376525032
85.03,2012,Mobile Home,0,0,0,
85.03,2012,Multifamily,1049,899,150,0.142993326978074
85.03,2012,Single Family - Detached,1999,1955,44,0.0220110055027514
85.03,2020,Mobile Home,0,0,0,
85.03,2020,Multifamily,1049,881,168,0.160152526215443
85.03,2020,Single Family - Detached,2009,1952,57,0.0283723245395719
85.03,2025,Mobile Home,0,0,0,
85.03,2025,Multifamily,1049,885,164,0.156339370829361
85.03,2025,Single Family - Detached,2017,1978,39,0.0193356470004958
85.03,2030,Mobile Home,0,0,0,
85.03,2030,Multifamily,1049,883,166,0.158245948522402
85.03,2030,Single Family - Detached,2043,2000,43,0.0210474791972589
85.03,2035,Mobile Home,0,0,0,
85.03,2035,Multifamily,1049,886,163,0.155386081982841
85.03,2035,Single Family - Detached,2063,2027,36,0.0174503150751333
85.03,2040,Mobile Home,0,0,0,
85.03,2040,Multifamily,1083,911,172,0.15881809787627
85.03,2040,Single Family - Detached,2069,2025,44,0.0212663122281295
85.03,2045,Mobile Home,0,0,0,
85.03,2045,Multifamily,1101,884,217,0.197093551316985
85.03,2045,Single Family - Detached,2069,2023,46,0.0222329627839536
85.03,2050,Mobile Home,0,0,0,
85.03,2050,Multifamily,1101,879,222,0.201634877384196
85.03,2050,Single Family - Detached,2076,2028,48,0.023121387283237
85.04,2012,Mobile Home,0,0,0,
85.04,2012,Multifamily,127,127,0,0
85.04,2012,Single Family - Detached,2234,2199,35,0.0156669650850492
85.04,2020,Mobile Home,0,0,0,
85.04,2020,Multifamily,298,292,6,0.0201342281879195
85.04,2020,Single Family - Detached,2263,2226,37,0.0163499779054353
85.04,2025,Mobile Home,0,0,0,
85.04,2025,Multifamily,372,368,4,0.010752688172043
85.04,2025,Single Family - Detached,2231,2205,26,0.0116539668310175
85.04,2030,Mobile Home,0,0,0,
85.04,2030,Multifamily,400,393,7,0.0175
85.04,2030,Single Family - Detached,2218,2191,27,0.0121731289449955
85.04,2035,Mobile Home,0,0,0,
85.04,2035,Multifamily,427,421,6,0.0140515222482436
85.04,2035,Single Family - Detached,2212,2188,24,0.0108499095840868
85.04,2040,Mobile Home,0,0,0,
85.04,2040,Multifamily,435,426,9,0.0206896551724138
85.04,2040,Single Family - Detached,2208,2179,29,0.0131340579710145
85.04,2045,Mobile Home,0,0,0,
85.04,2045,Multifamily,435,382,53,0.12183908045977
85.04,2045,Single Family - Detached,2208,2178,30,0.0135869565217391
85.04,2050,Mobile Home,0,0,0,
85.04,2050,Multifamily,435,376,59,0.135632183908046
85.04,2050,Single Family - Detached,2208,2176,32,0.0144927536231884
85.05,2012,Mobile Home,0,0,0,
85.05,2012,Multifamily,475,452,23,0.0484210526315789
85.05,2012,Single Family - Detached,1683,1659,24,0.0142602495543672
85.05,2020,Mobile Home,0,0,0,
85.05,2020,Multifamily,538,509,29,0.0539033457249071
85.05,2020,Single Family - Detached,1664,1642,22,0.0132211538461538
85.05,2025,Mobile Home,0,0,0,
85.05,2025,Multifamily,574,551,23,0.0400696864111498
85.05,2025,Single Family - Detached,1658,1644,14,0.00844390832328106
85.05,2030,Mobile Home,0,0,0,
85.05,2030,Multifamily,574,548,26,0.0452961672473868
85.05,2030,Single Family - Detached,1658,1643,15,0.00904704463208685
85.05,2035,Mobile Home,0,0,0,
85.05,2035,Multifamily,576,553,23,0.0399305555555556
85.05,2035,Single Family - Detached,1658,1645,13,0.00784077201447527
85.05,2040,Mobile Home,0,0,0,
85.05,2040,Multifamily,702,658,44,0.0626780626780627
85.05,2040,Single Family - Detached,1658,1641,17,0.0102533172496984
85.05,2045,Mobile Home,0,0,0,
85.05,2045,Multifamily,728,679,49,0.0673076923076923
85.05,2045,Single Family - Detached,1658,1639,19,0.01145958986731
85.05,2050,Mobile Home,0,0,0,
85.05,2050,Multifamily,728,678,50,0.0686813186813187
85.05,2050,Single Family - Detached,1658,1639,19,0.01145958986731
85.06,2012,Mobile Home,0,0,0,
85.06,2012,Multifamily,414,393,21,0.0507246376811594
85.06,2012,Single Family - Detached,1147,1124,23,0.020052310374891
85.06,2020,Mobile Home,0,0,0,
85.06,2020,Multifamily,437,411,26,0.0594965675057208
85.06,2020,Single Family - Detached,1136,1105,31,0.0272887323943662
85.06,2025,Mobile Home,0,0,0,
85.06,2025,Multifamily,448,426,22,0.0491071428571429
85.06,2025,Single Family - Detached,1136,1111,25,0.0220070422535211
85.06,2030,Mobile Home,0,0,0,
85.06,2030,Multifamily,468,444,24,0.0512820512820513
85.06,2030,Single Family - Detached,1136,1111,25,0.0220070422535211
85.06,2035,Mobile Home,0,0,0,
85.06,2035,Multifamily,471,457,14,0.029723991507431
85.06,2035,Single Family - Detached,1136,1112,24,0.0211267605633803
85.06,2040,Mobile Home,0,0,0,
85.06,2040,Multifamily,492,467,25,0.0508130081300813
85.06,2040,Single Family - Detached,1136,1110,26,0.022887323943662
85.06,2045,Mobile Home,0,0,0,
85.06,2045,Multifamily,497,468,29,0.0583501006036217
85.06,2045,Single Family - Detached,1136,1108,28,0.0246478873239437
85.06,2050,Mobile Home,0,0,0,
85.06,2050,Multifamily,497,467,30,0.0603621730382294
85.06,2050,Single Family - Detached,1136,1108,28,0.0246478873239437
85.07,2012,Mobile Home,0,0,0,
85.07,2012,Multifamily,1479,1435,44,0.0297498309668695
85.07,2012,Single Family - Detached,1463,1453,10,0.00683526999316473
85.07,2020,Mobile Home,0,0,0,
85.07,2020,Multifamily,1511,1475,36,0.0238252812706817
85.07,2020,Single Family - Detached,1468,1456,12,0.00817438692098093
85.07,2025,Mobile Home,0,0,0,
85.07,2025,Multifamily,1570,1534,36,0.0229299363057325
85.07,2025,Single Family - Detached,1468,1458,10,0.00681198910081744
85.07,2030,Mobile Home,0,0,0,
85.07,2030,Multifamily,1665,1629,36,0.0216216216216216
85.07,2030,Single Family - Detached,1469,1459,10,0.0068073519400953
85.07,2035,Mobile Home,0,0,0,
85.07,2035,Multifamily,1710,1666,44,0.0257309941520468
85.07,2035,Single Family - Detached,1469,1459,10,0.0068073519400953
85.07,2040,Mobile Home,0,0,0,
85.07,2040,Multifamily,1850,1820,30,0.0162162162162162
85.07,2040,Single Family - Detached,1469,1459,10,0.0068073519400953
85.07,2045,Mobile Home,0,0,0,
85.07,2045,Multifamily,1924,1893,31,0.0161122661122661
85.07,2045,Single Family - Detached,1469,1459,10,0.0068073519400953
85.07,2050,Mobile Home,0,0,0,
85.07,2050,Multifamily,1924,1893,31,0.0161122661122661
85.07,2050,Single Family - Detached,1469,1459,10,0.0068073519400953
85.09,2012,Mobile Home,0,0,0,
85.09,2012,Multifamily,1306,1274,32,0.0245022970903522
85.09,2012,Single Family - Detached,1459,1399,60,0.0411240575736806
85.09,2020,Mobile Home,0,0,0,
85.09,2020,Multifamily,1398,1375,23,0.0164520743919886
85.09,2020,Single Family - Detached,1460,1397,63,0.0431506849315069
85.09,2025,Mobile Home,0,0,0,
85.09,2025,Multifamily,1420,1403,17,0.0119718309859155
85.09,2025,Single Family - Detached,1461,1407,54,0.0369609856262834
85.09,2030,Mobile Home,0,0,0,
85.09,2030,Multifamily,1500,1482,18,0.012
85.09,2030,Single Family - Detached,1462,1407,55,0.0376196990424077
85.09,2035,Mobile Home,0,0,0,
85.09,2035,Multifamily,1534,1518,16,0.0104302477183833
85.09,2035,Single Family - Detached,1463,1412,51,0.0348598769651401
85.09,2040,Mobile Home,0,0,0,
85.09,2040,Multifamily,1585,1535,50,0.0315457413249211
85.09,2040,Single Family - Detached,1464,1410,54,0.0368852459016393
85.09,2045,Mobile Home,0,0,0,
85.09,2045,Multifamily,1585,1534,51,0.0321766561514196
85.09,2045,Single Family - Detached,1464,1409,55,0.037568306010929
85.09,2050,Mobile Home,0,0,0,
85.09,2050,Multifamily,1585,1533,52,0.032807570977918
85.09,2050,Single Family - Detached,1471,1413,58,0.0394289598912305
85.10,2012,Mobile Home,0,0,0,
85.10,2012,Multifamily,1479,1418,61,0.0412440838404327
85.10,2012,Single Family - Detached,1414,1365,49,0.0346534653465347
85.10,2020,Mobile Home,0,0,0,
85.10,2020,Multifamily,1488,1416,72,0.0483870967741935
85.10,2020,Single Family - Detached,1414,1358,56,0.0396039603960396
85.10,2025,Mobile Home,0,0,0,
85.10,2025,Multifamily,1490,1425,65,0.0436241610738255
85.10,2025,Single Family - Detached,1414,1372,42,0.0297029702970297
85.10,2030,Mobile Home,0,0,0,
85.10,2030,Multifamily,1532,1464,68,0.0443864229765013
85.10,2030,Single Family - Detached,1414,1371,43,0.0304101838755304
85.10,2035,Mobile Home,0,0,0,
85.10,2035,Multifamily,1535,1470,65,0.0423452768729642
85.10,2035,Single Family - Detached,1414,1375,39,0.0275813295615276
85.10,2040,Mobile Home,0,0,0,
85.10,2040,Multifamily,1544,1502,42,0.0272020725388601
85.10,2040,Single Family - Detached,1414,1369,45,0.0318246110325318
85.10,2045,Mobile Home,0,0,0,
85.10,2045,Multifamily,1544,1501,43,0.0278497409326425
85.10,2045,Single Family - Detached,1414,1368,46,0.0325318246110325
85.10,2050,Mobile Home,0,0,0,
85.10,2050,Multifamily,1544,1500,44,0.0284974093264249
85.10,2050,Single Family - Detached,1415,1369,46,0.0325088339222615
85.11,2012,Mobile Home,325,325,0,0
85.11,2012,Multifamily,893,749,144,0.161254199328108
85.11,2012,Single Family - Detached,144,151,-7,-0.0486111111111111
85.11,2020,Mobile Home,0,0,0,
85.11,2020,Multifamily,1939,1690,249,0.128416709644146
85.11,2020,Single Family - Detached,144,151,-7,-0.0486111111111111
85.11,2025,Mobile Home,0,0,0,
85.11,2025,Multifamily,2011,1872,139,0.0691198408751865
85.11,2025,Single Family - Detached,144,151,-7,-0.0486111111111111
85.11,2030,Mobile Home,0,0,0,
85.11,2030,Multifamily,2048,1921,127,0.06201171875
85.11,2030,Single Family - Detached,144,151,-7,-0.0486111111111111
85.11,2035,Mobile Home,0,0,0,
85.11,2035,Multifamily,2066,1956,110,0.05324298160697
85.11,2035,Single Family - Detached,144,151,-7,-0.0486111111111111
85.11,2040,Mobile Home,0,0,0,
85.11,2040,Multifamily,2067,1946,121,0.0585389453313982
85.11,2040,Single Family - Detached,144,150,-6,-0.0416666666666667
85.11,2045,Mobile Home,0,0,0,
85.11,2045,Multifamily,2067,1946,121,0.0585389453313982
85.11,2045,Single Family - Detached,144,150,-6,-0.0416666666666667
85.11,2050,Mobile Home,0,0,0,
85.11,2050,Multifamily,2067,1946,121,0.0585389453313982
85.11,2050,Single Family - Detached,144,150,-6,-0.0416666666666667
85.12,2012,Mobile Home,0,0,0,
85.12,2012,Multifamily,113,112,1,0.00884955752212389
85.12,2012,Single Family - Detached,1556,1526,30,0.019280205655527
85.12,2020,Mobile Home,0,0,0,
85.12,2020,Multifamily,113,112,1,0.00884955752212389
85.12,2020,Single Family - Detached,1556,1522,34,0.0218508997429306
85.12,2025,Mobile Home,0,0,0,
85.12,2025,Multifamily,113,113,0,0
85.12,2025,Single Family - Detached,1559,1545,14,0.00898011545862733
85.12,2030,Mobile Home,0,0,0,
85.12,2030,Multifamily,113,112,1,0.00884955752212389
85.12,2030,Single Family - Detached,1559,1544,15,0.00962155227710071
85.12,2035,Mobile Home,0,0,0,
85.12,2035,Multifamily,113,113,0,0
85.12,2035,Single Family - Detached,1559,1549,10,0.0064143681847338
85.12,2040,Mobile Home,0,0,0,
85.12,2040,Multifamily,113,110,3,0.0265486725663717
85.12,2040,Single Family - Detached,1559,1545,14,0.00898011545862733
85.12,2045,Mobile Home,0,0,0,
85.12,2045,Multifamily,113,109,4,0.0353982300884956
85.12,2045,Single Family - Detached,1559,1538,21,0.013470173187941
85.12,2050,Mobile Home,0,0,0,
85.12,2050,Multifamily,113,109,4,0.0353982300884956
85.12,2050,Single Family - Detached,1559,1538,21,0.013470173187941
85.13,2012,Mobile Home,0,0,0,
85.13,2012,Multifamily,42,42,0,0
85.13,2012,Single Family - Detached,1088,1072,16,0.0147058823529412
85.13,2020,Mobile Home,0,0,0,
85.13,2020,Multifamily,42,42,0,0
85.13,2020,Single Family - Detached,1088,1069,19,0.0174632352941176
85.13,2025,Mobile Home,0,0,0,
85.13,2025,Multifamily,42,42,0,0
85.13,2025,Single Family - Detached,1089,1072,17,0.0156106519742883
85.13,2030,Mobile Home,0,0,0,
85.13,2030,Multifamily,42,42,0,0
85.13,2030,Single Family - Detached,1089,1072,17,0.0156106519742883
85.13,2035,Mobile Home,0,0,0,
85.13,2035,Multifamily,42,42,0,0
85.13,2035,Single Family - Detached,1089,1073,16,0.014692378328742
85.13,2040,Mobile Home,0,0,0,
85.13,2040,Multifamily,42,40,2,0.0476190476190476
85.13,2040,Single Family - Detached,1089,1070,19,0.0174471992653811
85.13,2045,Mobile Home,0,0,0,
85.13,2045,Multifamily,42,39,3,0.0714285714285714
85.13,2045,Single Family - Detached,1089,1067,22,0.0202020202020202
85.13,2050,Mobile Home,0,0,0,
85.13,2050,Multifamily,42,39,3,0.0714285714285714
85.13,2050,Single Family - Detached,1089,1065,24,0.0220385674931129
86,2012,Mobile Home,220,220,0,0
86,2012,Multifamily,665,645,20,0.0300751879699248
86,2012,Single Family - Detached,1132,1113,19,0.0167844522968198
86,2020,Mobile Home,220,220,0,0
86,2020,Multifamily,665,633,32,0.0481203007518797
86,2020,Single Family - Detached,1298,1278,20,0.0154083204930663
86,2025,Mobile Home,220,220,0,0
86,2025,Multifamily,665,635,30,0.0451127819548872
86,2025,Single Family - Detached,1477,1460,17,0.011509817197021
86,2030,Mobile Home,220,219,1,0.00454545454545455
86,2030,Multifamily,665,633,32,0.0481203007518797
86,2030,Single Family - Detached,1567,1549,18,0.01148691767709
86,2035,Mobile Home,220,219,1,0.00454545454545455
86,2035,Multifamily,665,635,30,0.0451127819548872
86,2035,Single Family - Detached,1609,1592,17,0.0105655686761964
86,2040,Mobile Home,220,219,1,0.00454545454545455
86,2040,Multifamily,1624,1578,46,0.0283251231527094
86,2040,Single Family - Detached,1726,1708,18,0.0104287369640788
86,2045,Mobile Home,220,218,2,0.00909090909090909
86,2045,Multifamily,1638,1587,51,0.0311355311355311
86,2045,Single Family - Detached,1726,1707,19,0.0110081112398609
86,2050,Mobile Home,220,214,6,0.0272727272727273
86,2050,Multifamily,1638,1587,51,0.0311355311355311
86,2050,Single Family - Detached,1736,1717,19,0.0109447004608295
87.01,2012,Mobile Home,0,0,0,
87.01,2012,Multifamily,656,625,31,0.0472560975609756
87.01,2012,Single Family - Detached,614,597,17,0.0276872964169381
87.01,2020,Mobile Home,0,0,0,
87.01,2020,Multifamily,656,617,39,0.0594512195121951
87.01,2020,Single Family - Detached,614,586,28,0.0456026058631922
87.01,2025,Mobile Home,0,0,0,
87.01,2025,Multifamily,656,618,38,0.0579268292682927
87.01,2025,Single Family - Detached,614,590,24,0.0390879478827362
87.01,2030,Mobile Home,0,0,0,
87.01,2030,Multifamily,656,617,39,0.0594512195121951
87.01,2030,Single Family - Detached,614,589,25,0.0407166123778502
87.01,2035,Mobile Home,0,0,0,
87.01,2035,Multifamily,656,618,38,0.0579268292682927
87.01,2035,Single Family - Detached,614,590,24,0.0390879478827362
87.01,2040,Mobile Home,0,0,0,
87.01,2040,Multifamily,664,632,32,0.0481927710843374
87.01,2040,Single Family - Detached,614,587,27,0.0439739413680782
87.01,2045,Mobile Home,0,0,0,
87.01,2045,Multifamily,748,721,27,0.036096256684492
87.01,2045,Single Family - Detached,614,586,28,0.0456026058631922
87.01,2050,Mobile Home,0,0,0,
87.01,2050,Multifamily,756,726,30,0.0396825396825397
87.01,2050,Single Family - Detached,614,586,28,0.0456026058631922
87.02,2012,Mobile Home,0,0,0,
87.02,2012,Multifamily,1279,1233,46,0.035965598123534
87.02,2012,Single Family - Detached,527,514,13,0.0246679316888046
87.02,2020,Mobile Home,0,0,0,
87.02,2020,Multifamily,1377,1337,40,0.0290486564996369
87.02,2020,Single Family - Detached,523,515,8,0.0152963671128107
87.02,2025,Mobile Home,0,0,0,
87.02,2025,Multifamily,1460,1424,36,0.0246575342465753
87.02,2025,Single Family - Detached,526,520,6,0.0114068441064639
87.02,2030,Mobile Home,0,0,0,
87.02,2030,Multifamily,1477,1434,43,0.029113067027759
87.02,2030,Single Family - Detached,526,519,7,0.0133079847908745
87.02,2035,Mobile Home,0,0,0,
87.02,2035,Multifamily,1512,1467,45,0.0297619047619048
87.02,2035,Single Family - Detached,526,521,5,0.00950570342205323
87.02,2040,Mobile Home,0,0,0,
87.02,2040,Multifamily,1573,1507,66,0.041958041958042
87.02,2040,Single Family - Detached,526,520,6,0.0114068441064639
87.02,2045,Mobile Home,0,0,0,
87.02,2045,Multifamily,1573,1501,72,0.045772409408773
87.02,2045,Single Family - Detached,526,519,7,0.0133079847908745
87.02,2050,Mobile Home,0,0,0,
87.02,2050,Multifamily,1573,1501,72,0.045772409408773
87.02,2050,Single Family - Detached,526,518,8,0.0152091254752852
88,2012,Mobile Home,0,0,0,
88,2012,Multifamily,898,854,44,0.0489977728285078
88,2012,Single Family - Detached,1131,1076,55,0.0486295313881521
88,2020,Mobile Home,0,0,0,
88,2020,Multifamily,1053,1024,29,0.0275403608736942
88,2020,Single Family - Detached,1255,1192,63,0.050199203187251
88,2025,Mobile Home,0,0,0,
88,2025,Multifamily,1211,1187,24,0.0198183319570603
88,2025,Single Family - Detached,1257,1205,52,0.0413683373110581
88,2030,Mobile Home,0,0,0,
88,2030,Multifamily,1392,1363,29,0.0208333333333333
88,2030,Single Family - Detached,1257,1202,55,0.0437549721559268
88,2035,Mobile Home,0,0,0,
88,2035,Multifamily,1396,1371,25,0.0179083094555874
88,2035,Single Family - Detached,1257,1207,50,0.0397772474144789
88,2040,Mobile Home,0,0,0,
88,2040,Multifamily,1834,1757,77,0.0419847328244275
88,2040,Single Family - Detached,1248,1189,59,0.047275641025641
88,2045,Mobile Home,0,0,0,
88,2045,Multifamily,1886,1794,92,0.0487804878048781
88,2045,Single Family - Detached,1235,1167,68,0.0550607287449393
88,2050,Mobile Home,0,0,0,
88,2050,Multifamily,1891,1796,95,0.0502379693283977
88,2050,Single Family - Detached,1233,1161,72,0.0583941605839416
89.01,2012,Mobile Home,0,0,0,
89.01,2012,Multifamily,1829,1675,154,0.0841990158556588
89.01,2012,Single Family - Detached,721,701,20,0.0277392510402219
89.01,2020,Mobile Home,0,0,0,
89.01,2020,Multifamily,1937,1811,126,0.0650490449148167
89.01,2020,Single Family - Detached,726,708,18,0.0247933884297521
89.01,2025,Mobile Home,0,0,0,
89.01,2025,Multifamily,1998,1887,111,0.0555555555555556
89.01,2025,Single Family - Detached,781,776,5,0.00640204865556978
89.01,2030,Mobile Home,0,0,0,
89.01,2030,Multifamily,2075,1952,123,0.0592771084337349
89.01,2030,Single Family - Detached,782,778,4,0.0051150895140665
89.01,2035,Mobile Home,0,0,0,
89.01,2035,Multifamily,2093,1912,181,0.0864787386526517
89.01,2035,Single Family - Detached,786,776,10,0.0127226463104326
89.01,2040,Mobile Home,0,0,0,
89.01,2040,Multifamily,2153,1952,201,0.0933581049698096
89.01,2040,Single Family - Detached,786,770,16,0.0203562340966921
89.01,2045,Mobile Home,0,0,0,
89.01,2045,Multifamily,2160,1920,240,0.111111111111111
89.01,2045,Single Family - Detached,786,767,19,0.0241730279898219
89.01,2050,Mobile Home,0,0,0,
89.01,2050,Multifamily,2160,1900,260,0.12037037037037
89.01,2050,Single Family - Detached,786,767,19,0.0241730279898219
89.02,2012,Mobile Home,0,0,0,
89.02,2012,Multifamily,1555,1272,283,0.181993569131833
89.02,2012,Single Family - Detached,30,28,2,0.0666666666666667
89.02,2020,Mobile Home,0,0,0,
89.02,2020,Multifamily,2884,2474,410,0.142163661581137
89.02,2020,Single Family - Detached,30,27,3,0.1
89.02,2025,Mobile Home,0,0,0,
89.02,2025,Multifamily,2884,2499,385,0.133495145631068
89.02,2025,Single Family - Detached,30,27,3,0.1
89.02,2030,Mobile Home,0,0,0,
89.02,2030,Multifamily,2884,2438,446,0.154646324549237
89.02,2030,Single Family - Detached,90,89,1,0.0111111111111111
89.02,2035,Mobile Home,0,0,0,
89.02,2035,Multifamily,2884,2403,481,0.166782246879334
89.02,2035,Single Family - Detached,99,98,1,0.0101010101010101
89.02,2040,Mobile Home,0,0,0,
89.02,2040,Multifamily,2884,2371,513,0.177877947295423
89.02,2040,Single Family - Detached,99,98,1,0.0101010101010101
89.02,2045,Mobile Home,0,0,0,
89.02,2045,Multifamily,2884,2317,567,0.196601941747573
89.02,2045,Single Family - Detached,99,98,1,0.0101010101010101
89.02,2050,Mobile Home,0,0,0,
89.02,2050,Multifamily,2884,2312,572,0.198335644937587
89.02,2050,Single Family - Detached,99,98,1,0.0101010101010101
9,2012,Mobile Home,0,0,0,
9,2012,Multifamily,2549,2430,119,0.0466849744998038
9,2012,Single Family - Detached,644,595,49,0.0760869565217391
9,2020,Mobile Home,0,0,0,
9,2020,Multifamily,2584,2443,141,0.0545665634674923
9,2020,Single Family - Detached,644,581,63,0.0978260869565217
9,2025,Mobile Home,0,0,0,
9,2025,Multifamily,2584,2443,141,0.0545665634674923
9,2025,Single Family - Detached,644,593,51,0.0791925465838509
9,2030,Mobile Home,0,0,0,
9,2030,Multifamily,2584,2428,156,0.0603715170278638
9,2030,Single Family - Detached,644,592,52,0.0807453416149068
9,2035,Mobile Home,0,0,0,
9,2035,Multifamily,2584,2428,156,0.0603715170278638
9,2035,Single Family - Detached,644,593,51,0.0791925465838509
9,2040,Mobile Home,0,0,0,
9,2040,Multifamily,2584,2407,177,0.0684984520123839
9,2040,Single Family - Detached,643,592,51,0.0793157076205288
9,2045,Mobile Home,0,0,0,
9,2045,Multifamily,3421,3279,142,0.0415083308973984
9,2045,Single Family - Detached,437,408,29,0.0663615560640732
9,2050,Mobile Home,0,0,0,
9,2050,Multifamily,4049,3918,131,0.0323536675722401
9,2050,Single Family - Detached,231,209,22,0.0952380952380952
90,2012,Mobile Home,0,0,0,
90,2012,Multifamily,567,547,20,0.0352733686067019
90,2012,Single Family - Detached,761,719,42,0.0551905387647832
90,2020,Mobile Home,0,0,0,
90,2020,Multifamily,567,534,33,0.0582010582010582
90,2020,Single Family - Detached,761,719,42,0.0551905387647832
90,2025,Mobile Home,0,0,0,
90,2025,Multifamily,661,628,33,0.0499243570347958
90,2025,Single Family - Detached,726,684,42,0.0578512396694215
90,2030,Mobile Home,0,0,0,
90,2030,Multifamily,736,697,39,0.0529891304347826
90,2030,Single Family - Detached,716,674,42,0.058659217877095
90,2035,Mobile Home,0,0,0,
90,2035,Multifamily,806,766,40,0.0496277915632754
90,2035,Single Family - Detached,766,760,6,0.00783289817232376
90,2040,Mobile Home,0,0,0,
90,2040,Multifamily,966,913,53,0.0548654244306418
90,2040,Single Family - Detached,766,758,8,0.010443864229765
90,2045,Mobile Home,0,0,0,
90,2045,Multifamily,1194,1131,63,0.0527638190954774
90,2045,Single Family - Detached,766,756,10,0.0130548302872063
90,2050,Mobile Home,0,0,0,
90,2050,Multifamily,1194,1118,76,0.0636515912897822
90,2050,Single Family - Detached,766,756,10,0.0130548302872063
91.01,2012,Mobile Home,0,0,0,
91.01,2012,Multifamily,403,402,1,0.00248138957816377
91.01,2012,Single Family - Detached,1993,1897,96,0.0481685900652283
91.01,2020,Mobile Home,0,0,0,
91.01,2020,Multifamily,404,401,3,0.00742574257425743
91.01,2020,Single Family - Detached,1993,1893,100,0.0501756146512795
91.01,2025,Mobile Home,0,0,0,
91.01,2025,Multifamily,405,404,1,0.00246913580246914
91.01,2025,Single Family - Detached,2003,1907,96,0.0479281078382426
91.01,2030,Mobile Home,0,0,0,
91.01,2030,Multifamily,431,428,3,0.00696055684454756
91.01,2030,Single Family - Detached,2010,1914,96,0.0477611940298507
91.01,2035,Mobile Home,0,0,0,
91.01,2035,Multifamily,552,550,2,0.0036231884057971
91.01,2035,Single Family - Detached,2010,1915,95,0.0472636815920398
91.01,2040,Mobile Home,0,0,0,
91.01,2040,Multifamily,1035,1008,27,0.0260869565217391
91.01,2040,Single Family - Detached,1964,1866,98,0.04989816700611
91.01,2045,Mobile Home,0,0,0,
91.01,2045,Multifamily,1038,1003,35,0.033718689788054
91.01,2045,Single Family - Detached,1980,1887,93,0.046969696969697
91.01,2050,Mobile Home,0,0,0,
91.01,2050,Multifamily,1038,998,40,0.0385356454720617
91.01,2050,Single Family - Detached,1981,1887,94,0.0474507824331146
91.02,2012,Mobile Home,0,0,0,
91.02,2012,Multifamily,1641,1623,18,0.0109689213893967
91.02,2012,Single Family - Detached,211,195,16,0.0758293838862559
91.02,2020,Mobile Home,0,0,0,
91.02,2020,Multifamily,1699,1684,15,0.00882872277810477
91.02,2020,Single Family - Detached,211,194,17,0.0805687203791469
91.02,2025,Mobile Home,0,0,0,
91.02,2025,Multifamily,1763,1748,15,0.00850822461712989
91.02,2025,Single Family - Detached,211,194,17,0.0805687203791469
91.02,2030,Mobile Home,0,0,0,
91.02,2030,Multifamily,2069,2052,17,0.00821652972450459
91.02,2030,Single Family - Detached,211,194,17,0.0805687203791469
91.02,2035,Mobile Home,0,0,0,
91.02,2035,Multifamily,2166,2148,18,0.00831024930747922
91.02,2035,Single Family - Detached,211,194,17,0.0805687203791469
91.02,2040,Mobile Home,0,0,0,
91.02,2040,Multifamily,2556,2531,25,0.00978090766823161
91.02,2040,Single Family - Detached,211,194,17,0.0805687203791469
91.02,2045,Mobile Home,0,0,0,
91.02,2045,Multifamily,2772,2742,30,0.0108225108225108
91.02,2045,Single Family - Detached,211,192,19,0.0900473933649289
91.02,2050,Mobile Home,0,0,0,
91.02,2050,Multifamily,2773,2744,29,0.0104579877389109
91.02,2050,Single Family - Detached,211,192,19,0.0900473933649289
91.03,2012,Mobile Home,0,0,0,
91.03,2012,Multifamily,418,397,21,0.0502392344497608
91.03,2012,Single Family - Detached,1282,1242,40,0.031201248049922
91.03,2020,Mobile Home,0,0,0,
91.03,2020,Multifamily,424,405,19,0.044811320754717
91.03,2020,Single Family - Detached,1282,1236,46,0.0358814352574103
91.03,2025,Mobile Home,0,0,0,
91.03,2025,Multifamily,424,406,18,0.0424528301886792
91.03,2025,Single Family - Detached,1289,1262,27,0.0209464701318852
91.03,2030,Mobile Home,0,0,0,
91.03,2030,Multifamily,424,405,19,0.044811320754717
91.03,2030,Single Family - Detached,1292,1264,28,0.021671826625387
91.03,2035,Mobile Home,0,0,0,
91.03,2035,Multifamily,424,405,19,0.044811320754717
91.03,2035,Single Family - Detached,1295,1275,20,0.0154440154440154
91.03,2040,Mobile Home,0,0,0,
91.03,2040,Multifamily,424,389,35,0.0825471698113208
91.03,2040,Single Family - Detached,1296,1271,25,0.0192901234567901
91.03,2045,Mobile Home,0,0,0,
91.03,2045,Multifamily,671,636,35,0.0521609538002981
91.03,2045,Single Family - Detached,1298,1264,34,0.0261941448382126
91.03,2050,Mobile Home,0,0,0,
91.03,2050,Multifamily,673,637,36,0.0534918276374443
91.03,2050,Single Family - Detached,1298,1260,38,0.0292758089368259
91.04,2012,Mobile Home,0,0,0,
91.04,2012,Multifamily,48,47,1,0.0208333333333333
91.04,2012,Single Family - Detached,1120,1106,14,0.0125
91.04,2020,Mobile Home,0,0,0,
91.04,2020,Multifamily,48,45,3,0.0625
91.04,2020,Single Family - Detached,1121,1103,18,0.016057091882248
91.04,2025,Mobile Home,0,0,0,
91.04,2025,Multifamily,48,46,2,0.0416666666666667
91.04,2025,Single Family - Detached,1128,1114,14,0.0124113475177305
91.04,2030,Mobile Home,0,0,0,
91.04,2030,Multifamily,48,44,4,0.0833333333333333
91.04,2030,Single Family - Detached,1132,1117,15,0.0132508833922261
91.04,2035,Mobile Home,0,0,0,
91.04,2035,Multifamily,48,45,3,0.0625
91.04,2035,Single Family - Detached,1134,1120,14,0.0123456790123457
91.04,2040,Mobile Home,0,0,0,
91.04,2040,Multifamily,59,42,17,0.288135593220339
91.04,2040,Single Family - Detached,1134,1117,17,0.0149911816578483
91.04,2045,Mobile Home,0,0,0,
91.04,2045,Multifamily,342,315,27,0.0789473684210526
91.04,2045,Single Family - Detached,1148,1125,23,0.0200348432055749
91.04,2050,Mobile Home,0,0,0,
91.04,2050,Multifamily,342,314,28,0.0818713450292398
91.04,2050,Single Family - Detached,1149,1127,22,0.0191470844212359
91.06,2012,Mobile Home,197,175,22,0.111675126903553
91.06,2012,Multifamily,252,159,93,0.369047619047619
91.06,2012,Single Family - Detached,624,596,28,0.0448717948717949
91.06,2020,Mobile Home,129,115,14,0.108527131782946
91.06,2020,Multifamily,411,305,106,0.257907542579075
91.06,2020,Single Family - Detached,619,587,32,0.0516962843295638
91.06,2025,Mobile Home,90,80,10,0.111111111111111
91.06,2025,Multifamily,484,389,95,0.196280991735537
91.06,2025,Single Family - Detached,621,597,24,0.0386473429951691
91.06,2030,Mobile Home,90,80,10,0.111111111111111
91.06,2030,Multifamily,539,436,103,0.191094619666048
91.06,2030,Single Family - Detached,620,592,28,0.0451612903225806
91.06,2035,Mobile Home,90,80,10,0.111111111111111
91.06,2035,Multifamily,746,665,81,0.10857908847185
91.06,2035,Single Family - Detached,612,581,31,0.0506535947712418
91.06,2040,Mobile Home,0,0,0,
91.06,2040,Multifamily,1318,1221,97,0.0735963581183612
91.06,2040,Single Family - Detached,603,569,34,0.0563847429519071
91.06,2045,Mobile Home,0,0,0,
91.06,2045,Multifamily,2337,2145,192,0.0821566110397946
91.06,2045,Single Family - Detached,600,563,37,0.0616666666666667
91.06,2050,Mobile Home,0,0,0,
91.06,2050,Multifamily,2484,2292,192,0.0772946859903382
91.06,2050,Single Family - Detached,600,562,38,0.0633333333333333
91.07,2012,Mobile Home,0,0,0,
91.07,2012,Multifamily,1173,1063,110,0.0937766410912191
91.07,2012,Single Family - Detached,788,773,15,0.0190355329949239
91.07,2020,Mobile Home,0,0,0,
91.07,2020,Multifamily,1706,1516,190,0.11137162954279
91.07,2020,Single Family - Detached,788,772,16,0.0203045685279188
91.07,2025,Mobile Home,0,0,0,
91.07,2025,Multifamily,1706,1533,173,0.101406799531067
91.07,2025,Single Family - Detached,788,771,17,0.0215736040609137
91.07,2030,Mobile Home,0,0,0,
91.07,2030,Multifamily,1939,1752,187,0.0964414646725116
91.07,2030,Single Family - Detached,719,701,18,0.0250347705146036
91.07,2035,Mobile Home,0,0,0,
91.07,2035,Multifamily,2209,2050,159,0.0719782707107288
91.07,2035,Single Family - Detached,669,633,36,0.0538116591928251
91.07,2040,Mobile Home,0,0,0,
91.07,2040,Multifamily,2582,2396,186,0.0720371804802479
91.07,2040,Single Family - Detached,629,596,33,0.0524642289348172
91.07,2045,Mobile Home,0,0,0,
91.07,2045,Multifamily,2671,2477,194,0.0726319730438038
91.07,2045,Single Family - Detached,672,636,36,0.0535714285714286
91.07,2050,Mobile Home,0,0,0,
91.07,2050,Multifamily,2704,2511,193,0.0713757396449704
91.07,2050,Single Family - Detached,676,638,38,0.0562130177514793
92.01,2012,Mobile Home,0,0,0,
92.01,2012,Multifamily,1230,1012,218,0.177235772357724
92.01,2012,Single Family - Detached,602,560,42,0.0697674418604651
92.01,2020,Mobile Home,0,0,0,
92.01,2020,Multifamily,1594,1294,300,0.188205771643664
92.01,2020,Single Family - Detached,602,556,46,0.0764119601328904
92.01,2025,Mobile Home,0,0,0,
92.01,2025,Multifamily,1594,1264,330,0.20702634880803
92.01,2025,Single Family - Detached,604,561,43,0.0711920529801325
92.01,2030,Mobile Home,0,0,0,
92.01,2030,Multifamily,1594,1252,342,0.214554579673777
92.01,2030,Single Family - Detached,604,561,43,0.0711920529801325
92.01,2035,Mobile Home,0,0,0,
92.01,2035,Multifamily,1594,1254,340,0.213299874529486
92.01,2035,Single Family - Detached,604,561,43,0.0711920529801325
92.01,2040,Mobile Home,0,0,0,
92.01,2040,Multifamily,1630,1306,324,0.198773006134969
92.01,2040,Single Family - Detached,604,558,46,0.076158940397351
92.01,2045,Mobile Home,0,0,0,
92.01,2045,Multifamily,1657,1330,327,0.197344598672299
92.01,2045,Single Family - Detached,604,555,49,0.0811258278145695
92.01,2050,Mobile Home,0,0,0,
92.01,2050,Multifamily,1659,1332,327,0.197106690777577
92.01,2050,Single Family - Detached,604,555,49,0.0811258278145695
92.02,2012,Mobile Home,0,0,0,
92.02,2012,Multifamily,414,412,2,0.00483091787439614
92.02,2012,Single Family - Detached,1418,1186,232,0.16361071932299
92.02,2020,Mobile Home,0,0,0,
92.02,2020,Multifamily,866,813,53,0.0612009237875289
92.02,2020,Single Family - Detached,1476,1319,157,0.106368563685637
92.02,2025,Mobile Home,0,0,0,
92.02,2025,Multifamily,1745,1645,100,0.0573065902578797
92.02,2025,Single Family - Detached,1513,1351,162,0.107072042300066
92.02,2030,Mobile Home,0,0,0,
92.02,2030,Multifamily,2737,2665,72,0.0263061746437706
92.02,2030,Single Family - Detached,1550,1378,172,0.110967741935484
92.02,2035,Mobile Home,0,0,0,
92.02,2035,Multifamily,4326,4139,187,0.0432269995376791
92.02,2035,Single Family - Detached,1552,1387,165,0.106314432989691
92.02,2040,Mobile Home,0,0,0,
92.02,2040,Multifamily,4821,4569,252,0.0522713130056005
92.02,2040,Single Family - Detached,1586,1407,179,0.112862547288777
92.02,2045,Mobile Home,0,0,0,
92.02,2045,Multifamily,5244,4944,300,0.05720823798627
92.02,2045,Single Family - Detached,1597,1406,191,0.119599248591108
92.02,2050,Mobile Home,0,0,0,
92.02,2050,Multifamily,5213,4912,301,0.0577402647228084
92.02,2050,Single Family - Detached,1607,1410,197,0.122588674548849
93.01,2012,Mobile Home,0,0,0,
93.01,2012,Multifamily,941,898,43,0.0456960680127524
93.01,2012,Single Family - Detached,815,812,3,0.00368098159509202
93.01,2020,Mobile Home,0,0,0,
93.01,2020,Multifamily,997,940,57,0.0571715145436309
93.01,2020,Single Family - Detached,815,807,8,0.0098159509202454
93.01,2025,Mobile Home,0,0,0,
93.01,2025,Multifamily,1041,992,49,0.0470701248799232
93.01,2025,Single Family - Detached,815,811,4,0.0049079754601227
93.01,2030,Mobile Home,0,0,0,
93.01,2030,Multifamily,1050,1000,50,0.0476190476190476
93.01,2030,Single Family - Detached,815,811,4,0.0049079754601227
93.01,2035,Mobile Home,0,0,0,
93.01,2035,Multifamily,1068,1019,49,0.0458801498127341
93.01,2035,Single Family - Detached,815,812,3,0.00368098159509202
93.01,2040,Mobile Home,0,0,0,
93.01,2040,Multifamily,1120,1058,62,0.0553571428571429
93.01,2040,Single Family - Detached,815,809,6,0.00736196319018405
93.01,2045,Mobile Home,0,0,0,
93.01,2045,Multifamily,1135,1069,66,0.0581497797356828
93.01,2045,Single Family - Detached,815,806,9,0.0110429447852761
93.01,2050,Mobile Home,0,0,0,
93.01,2050,Multifamily,1136,1070,66,0.0580985915492958
93.01,2050,Single Family - Detached,817,807,10,0.0122399020807834
93.04,2012,Mobile Home,0,0,0,
93.04,2012,Multifamily,4736,4245,491,0.103673986486486
93.04,2012,Single Family - Detached,123,111,12,0.0975609756097561
93.04,2020,Mobile Home,0,0,0,
93.04,2020,Multifamily,5835,5235,600,0.102827763496144
93.04,2020,Single Family - Detached,123,71,52,0.422764227642276
93.04,2025,Mobile Home,0,0,0,
93.04,2025,Multifamily,6152,5614,538,0.0874512353706112
93.04,2025,Single Family - Detached,122,69,53,0.434426229508197
93.04,2030,Mobile Home,0,0,0,
93.04,2030,Multifamily,6547,5976,571,0.0872155185581182
93.04,2030,Single Family - Detached,122,64,58,0.475409836065574
93.04,2035,Mobile Home,0,0,0,
93.04,2035,Multifamily,7090,6601,489,0.0689703808180536
93.04,2035,Single Family - Detached,122,68,54,0.442622950819672
93.04,2040,Mobile Home,0,0,0,
93.04,2040,Multifamily,7328,6817,511,0.0697325327510917
93.04,2040,Single Family - Detached,122,62,60,0.491803278688525
93.04,2045,Mobile Home,0,0,0,
93.04,2045,Multifamily,7533,7027,506,0.0671711137660958
93.04,2045,Single Family - Detached,122,57,65,0.532786885245902
93.04,2050,Mobile Home,0,0,0,
93.04,2050,Multifamily,7533,7023,510,0.0677021107128634
93.04,2050,Single Family - Detached,122,53,69,0.565573770491803
93.05,2012,Mobile Home,0,0,0,
93.05,2012,Multifamily,1136,1114,22,0.0193661971830986
93.05,2012,Single Family - Detached,1196,1177,19,0.0158862876254181
93.05,2020,Mobile Home,0,0,0,
93.05,2020,Multifamily,1138,1124,14,0.0123022847100176
93.05,2020,Single Family - Detached,1282,1217,65,0.0507020280811232
93.05,2025,Mobile Home,0,0,0,
93.05,2025,Multifamily,1138,1128,10,0.00878734622144113
93.05,2025,Single Family - Detached,1282,1220,62,0.0483619344773791
93.05,2030,Mobile Home,0,0,0,
93.05,2030,Multifamily,1138,1122,16,0.0140597539543058
93.05,2030,Single Family - Detached,1282,1215,67,0.0522620904836193
93.05,2035,Mobile Home,0,0,0,
93.05,2035,Multifamily,1138,1121,17,0.0149384885764499
93.05,2035,Single Family - Detached,1282,1218,64,0.0499219968798752
93.05,2040,Mobile Home,0,0,0,
93.05,2040,Multifamily,1138,1111,27,0.023725834797891
93.05,2040,Single Family - Detached,1282,1215,67,0.0522620904836193
93.05,2045,Mobile Home,0,0,0,
93.05,2045,Multifamily,1144,1116,28,0.0244755244755245
93.05,2045,Single Family - Detached,1282,1210,72,0.0561622464898596
93.05,2050,Mobile Home,0,0,0,
93.05,2050,Multifamily,1144,1114,30,0.0262237762237762
93.05,2050,Single Family - Detached,1282,1207,75,0.0585023400936037
93.06,2012,Mobile Home,0,0,0,
93.06,2012,Multifamily,1274,1200,74,0.0580847723704867
93.06,2012,Single Family - Detached,1252,1184,68,0.0543130990415335
93.06,2020,Mobile Home,0,0,0,
93.06,2020,Multifamily,1276,1154,122,0.0956112852664577
93.06,2020,Single Family - Detached,1252,1162,90,0.0718849840255591
93.06,2025,Mobile Home,0,0,0,
93.06,2025,Multifamily,1276,1127,149,0.116771159874608
93.06,2025,Single Family - Detached,1252,1178,74,0.0591054313099042
93.06,2030,Mobile Home,0,0,0,
93.06,2030,Multifamily,1276,1115,161,0.126175548589342
93.06,2030,Single Family - Detached,1252,1177,75,0.0599041533546326
93.06,2035,Mobile Home,0,0,0,
93.06,2035,Multifamily,1276,1118,158,0.123824451410658
93.06,2035,Single Family - Detached,1252,1182,70,0.0559105431309904
93.06,2040,Mobile Home,0,0,0,
93.06,2040,Multifamily,1278,1118,160,0.125195618153365
93.06,2040,Single Family - Detached,1252,1177,75,0.0599041533546326
93.06,2045,Mobile Home,0,0,0,
93.06,2045,Multifamily,1278,1112,166,0.129890453834116
93.06,2045,Single Family - Detached,1252,1169,83,0.0662939297124601
93.06,2050,Mobile Home,0,0,0,
93.06,2050,Multifamily,1278,1108,170,0.13302034428795
93.06,2050,Single Family - Detached,1252,1167,85,0.0678913738019169
94,2012,Mobile Home,0,0,0,
94,2012,Multifamily,1,0,1,1
94,2012,Single Family - Detached,527,489,38,0.0721062618595825
94,2020,Mobile Home,0,0,0,
94,2020,Multifamily,1401,1306,95,0.0678087080656674
94,2020,Single Family - Detached,527,488,39,0.0740037950664137
94,2025,Mobile Home,0,0,0,
94,2025,Multifamily,1401,1307,94,0.0670949321912919
94,2025,Single Family - Detached,527,489,38,0.0721062618595825
94,2030,Mobile Home,0,0,0,
94,2030,Multifamily,1401,1307,94,0.0670949321912919
94,2030,Single Family - Detached,527,489,38,0.0721062618595825
94,2035,Mobile Home,0,0,0,
94,2035,Multifamily,1401,1309,92,0.065667380442541
94,2035,Single Family - Detached,527,489,38,0.0721062618595825
94,2040,Mobile Home,0,0,0,
94,2040,Multifamily,1401,1305,96,0.0685224839400428
94,2040,Single Family - Detached,527,488,39,0.0740037950664137
94,2045,Mobile Home,0,0,0,
94,2045,Multifamily,1401,1304,97,0.0692362598144183
94,2045,Single Family - Detached,527,488,39,0.0740037950664137
94,2050,Mobile Home,0,0,0,
94,2050,Multifamily,1401,1303,98,0.0699500356887937
94,2050,Single Family - Detached,527,488,39,0.0740037950664137
95.02,2012,Mobile Home,0,0,0,
95.02,2012,Multifamily,344,340,4,0.0116279069767442
95.02,2012,Single Family - Detached,1187,1183,4,0.0033698399326032
95.02,2020,Mobile Home,0,0,0,
95.02,2020,Multifamily,344,342,2,0.00581395348837209
95.02,2020,Single Family - Detached,1187,1182,5,0.004212299915754
95.02,2025,Mobile Home,0,0,0,
95.02,2025,Multifamily,344,343,1,0.00290697674418605
95.02,2025,Single Family - Detached,1187,1183,4,0.0033698399326032
95.02,2030,Mobile Home,0,0,0,
95.02,2030,Multifamily,344,343,1,0.00290697674418605
95.02,2030,Single Family - Detached,1187,1183,4,0.0033698399326032
95.02,2035,Mobile Home,0,0,0,
95.02,2035,Multifamily,344,344,0,0
95.02,2035,Single Family - Detached,1187,1183,4,0.0033698399326032
95.02,2040,Mobile Home,0,0,0,
95.02,2040,Multifamily,344,344,0,0
95.02,2040,Single Family - Detached,1187,1181,6,0.0050547598989048
95.02,2045,Mobile Home,0,0,0,
95.02,2045,Multifamily,344,344,0,0
95.02,2045,Single Family - Detached,1187,1180,7,0.0058972198820556
95.02,2050,Mobile Home,0,0,0,
95.02,2050,Multifamily,344,344,0,0
95.02,2050,Single Family - Detached,1187,1180,7,0.0058972198820556
95.04,2012,Mobile Home,0,0,0,
95.04,2012,Multifamily,107,106,1,0.00934579439252336
95.04,2012,Single Family - Detached,1831,1811,20,0.0109229929000546
95.04,2020,Mobile Home,0,0,0,
95.04,2020,Multifamily,254,250,4,0.015748031496063
95.04,2020,Single Family - Detached,2285,2244,41,0.0179431072210066
95.04,2025,Mobile Home,0,0,0,
95.04,2025,Multifamily,254,251,3,0.0118110236220472
95.04,2025,Single Family - Detached,2287,2255,32,0.0139921294271972
95.04,2030,Mobile Home,0,0,0,
95.04,2030,Multifamily,254,251,3,0.0118110236220472
95.04,2030,Single Family - Detached,2288,2255,33,0.0144230769230769
95.04,2035,Mobile Home,0,0,0,
95.04,2035,Multifamily,254,252,2,0.0078740157480315
95.04,2035,Single Family - Detached,2290,2261,29,0.0126637554585153
95.04,2040,Mobile Home,0,0,0,
95.04,2040,Multifamily,254,252,2,0.0078740157480315
95.04,2040,Single Family - Detached,2295,2258,37,0.0161220043572985
95.04,2045,Mobile Home,0,0,0,
95.04,2045,Multifamily,254,252,2,0.0078740157480315
95.04,2045,Single Family - Detached,2295,2255,40,0.0174291938997821
95.04,2050,Mobile Home,0,0,0,
95.04,2050,Multifamily,254,252,2,0.0078740157480315
95.04,2050,Single Family - Detached,2308,2268,40,0.0173310225303293
95.05,2012,Mobile Home,0,0,0,
95.05,2012,Multifamily,543,542,1,0.00184162062615101
95.05,2012,Single Family - Detached,2215,2147,68,0.0306997742663657
95.05,2020,Mobile Home,0,0,0,
95.05,2020,Multifamily,543,543,0,0
95.05,2020,Single Family - Detached,2215,2144,71,0.0320541760722348
95.05,2025,Mobile Home,0,0,0,
95.05,2025,Multifamily,543,543,0,0
95.05,2025,Single Family - Detached,2215,2148,67,0.0302483069977427
95.05,2030,Mobile Home,0,0,0,
95.05,2030,Multifamily,543,543,0,0
95.05,2030,Single Family - Detached,2215,2148,67,0.0302483069977427
95.05,2035,Mobile Home,0,0,0,
95.05,2035,Multifamily,543,543,0,0
95.05,2035,Single Family - Detached,2215,2150,65,0.0293453724604966
95.05,2040,Mobile Home,0,0,0,
95.05,2040,Multifamily,543,540,3,0.00552486187845304
95.05,2040,Single Family - Detached,2215,2146,69,0.0311512415349887
95.05,2045,Mobile Home,0,0,0,
95.05,2045,Multifamily,543,540,3,0.00552486187845304
95.05,2045,Single Family - Detached,2215,2143,72,0.0325056433408578
95.05,2050,Mobile Home,0,0,0,
95.05,2050,Multifamily,543,539,4,0.00736648250460405
95.05,2050,Single Family - Detached,2215,2143,72,0.0325056433408578
95.06,2012,Mobile Home,0,0,0,
95.06,2012,Multifamily,0,0,0,
95.06,2012,Single Family - Detached,1655,1627,28,0.0169184290030211
95.06,2020,Mobile Home,0,0,0,
95.06,2020,Multifamily,0,0,0,
95.06,2020,Single Family - Detached,1655,1625,30,0.0181268882175227
95.06,2025,Mobile Home,0,0,0,
95.06,2025,Multifamily,0,0,0,
95.06,2025,Single Family - Detached,1655,1627,28,0.0169184290030211
95.06,2030,Mobile Home,0,0,0,
95.06,2030,Multifamily,0,0,0,
95.06,2030,Single Family - Detached,1655,1627,28,0.0169184290030211
95.06,2035,Mobile Home,0,0,0,
95.06,2035,Multifamily,0,0,0,
95.06,2035,Single Family - Detached,1655,1628,27,0.0163141993957704
95.06,2040,Mobile Home,0,0,0,
95.06,2040,Multifamily,0,0,0,
95.06,2040,Single Family - Detached,1655,1625,30,0.0181268882175227
95.06,2045,Mobile Home,0,0,0,
95.06,2045,Multifamily,0,0,0,
95.06,2045,Single Family - Detached,1655,1623,32,0.0193353474320242
95.06,2050,Mobile Home,0,0,0,
95.06,2050,Multifamily,0,0,0,
95.06,2050,Single Family - Detached,1655,1623,32,0.0193353474320242
95.07,2012,Mobile Home,0,0,0,
95.07,2012,Multifamily,455,448,7,0.0153846153846154
95.07,2012,Single Family - Detached,1028,995,33,0.0321011673151751
95.07,2020,Mobile Home,0,0,0,
95.07,2020,Multifamily,455,450,5,0.010989010989011
95.07,2020,Single Family - Detached,1028,994,34,0.0330739299610895
95.07,2025,Mobile Home,0,0,0,
95.07,2025,Multifamily,498,493,5,0.0100401606425703
95.07,2025,Single Family - Detached,1028,996,32,0.0311284046692607
95.07,2030,Mobile Home,0,0,0,
95.07,2030,Multifamily,587,579,8,0.0136286201022147
95.07,2030,Single Family - Detached,1028,996,32,0.0311284046692607
95.07,2035,Mobile Home,0,0,0,
95.07,2035,Multifamily,697,690,7,0.0100430416068867
95.07,2035,Single Family - Detached,1028,997,31,0.0301556420233463
95.07,2040,Mobile Home,0,0,0,
95.07,2040,Multifamily,723,714,9,0.012448132780083
95.07,2040,Single Family - Detached,1028,995,33,0.0321011673151751
95.07,2045,Mobile Home,0,0,0,
95.07,2045,Multifamily,740,731,9,0.0121621621621622
95.07,2045,Single Family - Detached,1028,994,34,0.0330739299610895
95.07,2050,Mobile Home,0,0,0,
95.07,2050,Multifamily,749,741,8,0.0106809078771696
95.07,2050,Single Family - Detached,1028,994,34,0.0330739299610895
95.09,2012,Mobile Home,119,110,9,0.0756302521008403
95.09,2012,Multifamily,1637,1476,161,0.0983506414172266
95.09,2012,Single Family - Detached,458,449,9,0.0196506550218341
95.09,2020,Mobile Home,0,0,0,
95.09,2020,Multifamily,3039,2835,204,0.0671273445212241
95.09,2020,Single Family - Detached,482,471,11,0.0228215767634855
95.09,2025,Mobile Home,0,0,0,
95.09,2025,Multifamily,3057,2856,201,0.0657507360157017
95.09,2025,Single Family - Detached,482,472,10,0.020746887966805
95.09,2030,Mobile Home,0,0,0,
95.09,2030,Multifamily,3057,2852,205,0.0670592083742231
95.09,2030,Single Family - Detached,482,472,10,0.020746887966805
95.09,2035,Mobile Home,0,0,0,
95.09,2035,Multifamily,3057,2851,206,0.0673863264638535
95.09,2035,Single Family - Detached,482,473,9,0.0186721991701245
95.09,2040,Mobile Home,0,0,0,
95.09,2040,Multifamily,3057,2847,210,0.0686947988223749
95.09,2040,Single Family - Detached,482,472,10,0.020746887966805
95.09,2045,Mobile Home,0,0,0,
95.09,2045,Multifamily,3057,2842,215,0.0703303892705267
95.09,2045,Single Family - Detached,482,472,10,0.020746887966805
95.09,2050,Mobile Home,0,0,0,
95.09,2050,Multifamily,3057,2839,218,0.0713117435394177
95.09,2050,Single Family - Detached,482,472,10,0.020746887966805
95.10,2012,Mobile Home,0,0,0,
95.10,2012,Multifamily,0,0,0,
95.10,2012,Single Family - Detached,1285,1278,7,0.00544747081712062
95.10,2020,Mobile Home,0,0,0,
95.10,2020,Multifamily,0,0,0,
95.10,2020,Single Family - Detached,1285,1278,7,0.00544747081712062
95.10,2025,Mobile Home,0,0,0,
95.10,2025,Multifamily,0,0,0,
95.10,2025,Single Family - Detached,1285,1278,7,0.00544747081712062
95.10,2030,Mobile Home,0,0,0,
95.10,2030,Multifamily,0,0,0,
95.10,2030,Single Family - Detached,1285,1278,7,0.00544747081712062
95.10,2035,Mobile Home,0,0,0,
95.10,2035,Multifamily,0,0,0,
95.10,2035,Single Family - Detached,1285,1278,7,0.00544747081712062
95.10,2040,Mobile Home,0,0,0,
95.10,2040,Multifamily,0,0,0,
95.10,2040,Single Family - Detached,1285,1278,7,0.00544747081712062
95.10,2045,Mobile Home,0,0,0,
95.10,2045,Multifamily,0,0,0,
95.10,2045,Single Family - Detached,1285,1278,7,0.00544747081712062
95.10,2050,Mobile Home,0,0,0,
95.10,2050,Multifamily,0,0,0,
95.10,2050,Single Family - Detached,1285,1278,7,0.00544747081712062
95.11,2012,Mobile Home,0,0,0,
95.11,2012,Multifamily,0,0,0,
95.11,2012,Single Family - Detached,1034,1020,14,0.0135396518375242
95.11,2020,Mobile Home,0,0,0,
95.11,2020,Multifamily,0,0,0,
95.11,2020,Single Family - Detached,1034,1020,14,0.0135396518375242
95.11,2025,Mobile Home,0,0,0,
95.11,2025,Multifamily,0,0,0,
95.11,2025,Single Family - Detached,1034,1020,14,0.0135396518375242
95.11,2030,Mobile Home,0,0,0,
95.11,2030,Multifamily,0,0,0,
95.11,2030,Single Family - Detached,1034,1020,14,0.0135396518375242
95.11,2035,Mobile Home,0,0,0,
95.11,2035,Multifamily,0,0,0,
95.11,2035,Single Family - Detached,1034,1021,13,0.0125725338491296
95.11,2040,Mobile Home,0,0,0,
95.11,2040,Multifamily,0,0,0,
95.11,2040,Single Family - Detached,1034,1021,13,0.0125725338491296
95.11,2045,Mobile Home,0,0,0,
95.11,2045,Multifamily,0,0,0,
95.11,2045,Single Family - Detached,1034,1021,13,0.0125725338491296
95.11,2050,Mobile Home,0,0,0,
95.11,2050,Multifamily,0,0,0,
95.11,2050,Single Family - Detached,1034,1021,13,0.0125725338491296
96.02,2012,Mobile Home,251,251,0,0
96.02,2012,Multifamily,391,390,1,0.00255754475703325
96.02,2012,Single Family - Detached,1095,1057,38,0.034703196347032
96.02,2020,Mobile Home,251,246,5,0.0199203187250996
96.02,2020,Multifamily,391,382,9,0.0230179028132992
96.02,2020,Single Family - Detached,1109,1066,43,0.0387736699729486
96.02,2025,Mobile Home,251,246,5,0.0199203187250996
96.02,2025,Multifamily,391,384,7,0.0179028132992327
96.02,2025,Single Family - Detached,1109,1068,41,0.0369702434625789
96.02,2030,Mobile Home,251,245,6,0.0239043824701195
96.02,2030,Multifamily,391,375,16,0.040920716112532
96.02,2030,Single Family - Detached,1109,1068,41,0.0369702434625789
96.02,2035,Mobile Home,251,245,6,0.0239043824701195
96.02,2035,Multifamily,393,373,20,0.0508905852417303
96.02,2035,Single Family - Detached,1109,1068,41,0.0369702434625789
96.02,2040,Mobile Home,251,246,5,0.0199203187250996
96.02,2040,Multifamily,393,368,25,0.0636132315521628
96.02,2040,Single Family - Detached,1109,1066,43,0.0387736699729486
96.02,2045,Mobile Home,251,245,6,0.0239043824701195
96.02,2045,Multifamily,393,363,30,0.0763358778625954
96.02,2045,Single Family - Detached,1109,1064,45,0.0405770964833183
96.02,2050,Mobile Home,251,240,11,0.0438247011952191
96.02,2050,Multifamily,393,360,33,0.083969465648855
96.02,2050,Single Family - Detached,1109,1061,48,0.0432822362488729
96.03,2012,Mobile Home,0,0,0,
96.03,2012,Multifamily,2545,2473,72,0.0282907662082515
96.03,2012,Single Family - Detached,144,134,10,0.0694444444444444
96.03,2020,Mobile Home,0,0,0,
96.03,2020,Multifamily,3051,2939,112,0.0367092756473287
96.03,2020,Single Family - Detached,254,213,41,0.161417322834646
96.03,2025,Mobile Home,0,0,0,
96.03,2025,Multifamily,3051,2955,96,0.0314650934119961
96.03,2025,Single Family - Detached,358,352,6,0.0167597765363128
96.03,2030,Mobile Home,0,0,0,
96.03,2030,Multifamily,3285,3122,163,0.0496194824961948
96.03,2030,Single Family - Detached,445,436,9,0.0202247191011236
96.03,2035,Mobile Home,0,0,0,
96.03,2035,Multifamily,4295,4086,209,0.0486612339930151
96.03,2035,Single Family - Detached,446,443,3,0.00672645739910314
96.03,2040,Mobile Home,0,0,0,
96.03,2040,Multifamily,4558,4318,240,0.0526546731022378
96.03,2040,Single Family - Detached,502,495,7,0.0139442231075697
96.03,2045,Mobile Home,0,0,0,
96.03,2045,Multifamily,4690,4419,271,0.0577825159914712
96.03,2045,Single Family - Detached,516,506,10,0.0193798449612403
96.03,2050,Mobile Home,0,0,0,
96.03,2050,Multifamily,4702,4427,275,0.0584857507443641
96.03,2050,Single Family - Detached,526,518,8,0.0152091254752852
96.04,2012,Mobile Home,0,0,0,
96.04,2012,Multifamily,408,385,23,0.0563725490196078
96.04,2012,Single Family - Detached,1036,1003,33,0.0318532818532819
96.04,2020,Mobile Home,0,0,0,
96.04,2020,Multifamily,408,370,38,0.0931372549019608
96.04,2020,Single Family - Detached,1040,997,43,0.0413461538461538
96.04,2025,Mobile Home,0,0,0,
96.04,2025,Multifamily,1584,1508,76,0.047979797979798
96.04,2025,Single Family - Detached,1040,1000,40,0.0384615384615385
96.04,2030,Mobile Home,0,0,0,
96.04,2030,Multifamily,3071,2987,84,0.027352653858678
96.04,2030,Single Family - Detached,1040,999,41,0.0394230769230769
96.04,2035,Mobile Home,0,0,0,
96.04,2035,Multifamily,4183,4077,106,0.0253406645947884
96.04,2035,Single Family - Detached,1040,1000,40,0.0384615384615385
96.04,2040,Mobile Home,0,0,0,
96.04,2040,Multifamily,4419,4293,126,0.0285132382892057
96.04,2040,Single Family - Detached,1040,997,43,0.0413461538461538
96.04,2045,Mobile Home,0,0,0,
96.04,2045,Multifamily,4621,4481,140,0.0302964726249729
96.04,2045,Single Family - Detached,1040,996,44,0.0423076923076923
96.04,2050,Mobile Home,0,0,0,
96.04,2050,Multifamily,4783,4644,139,0.0290612586242944
96.04,2050,Single Family - Detached,1039,1010,29,0.0279114533205005
97.03,2012,Mobile Home,0,0,0,
97.03,2012,Multifamily,0,0,0,
97.03,2012,Single Family - Detached,1388,1370,18,0.0129682997118156
97.03,2020,Mobile Home,0,0,0,
97.03,2020,Multifamily,0,0,0,
97.03,2020,Single Family - Detached,1393,1373,20,0.0143575017946877
97.03,2025,Mobile Home,0,0,0,
97.03,2025,Multifamily,0,0,0,
97.03,2025,Single Family - Detached,1393,1373,20,0.0143575017946877
97.03,2030,Mobile Home,0,0,0,
97.03,2030,Multifamily,0,0,0,
97.03,2030,Single Family - Detached,1393,1373,20,0.0143575017946877
97.03,2035,Mobile Home,0,0,0,
97.03,2035,Multifamily,0,0,0,
97.03,2035,Single Family - Detached,1393,1373,20,0.0143575017946877
97.03,2040,Mobile Home,0,0,0,
97.03,2040,Multifamily,0,0,0,
97.03,2040,Single Family - Detached,1393,1373,20,0.0143575017946877
97.03,2045,Mobile Home,0,0,0,
97.03,2045,Multifamily,0,0,0,
97.03,2045,Single Family - Detached,1393,1373,20,0.0143575017946877
97.03,2050,Mobile Home,0,0,0,
97.03,2050,Multifamily,0,0,0,
97.03,2050,Single Family - Detached,1393,1372,21,0.0150753768844221
97.04,2012,Mobile Home,0,0,0,
97.04,2012,Multifamily,696,677,19,0.0272988505747126
97.04,2012,Single Family - Detached,1797,1747,50,0.0278241513633834
97.04,2020,Mobile Home,0,0,0,
97.04,2020,Multifamily,696,656,40,0.0574712643678161
97.04,2020,Single Family - Detached,1798,1741,57,0.0317018909899889
97.04,2025,Mobile Home,0,0,0,
97.04,2025,Multifamily,696,663,33,0.0474137931034483
97.04,2025,Single Family - Detached,1798,1744,54,0.0300333704115684
97.04,2030,Mobile Home,0,0,0,
97.04,2030,Multifamily,696,642,54,0.0775862068965517
97.04,2030,Single Family - Detached,1798,1742,56,0.0311457174638487
97.04,2035,Mobile Home,0,0,0,
97.04,2035,Multifamily,696,628,68,0.0977011494252874
97.04,2035,Single Family - Detached,1798,1744,54,0.0300333704115684
97.04,2040,Mobile Home,0,0,0,
97.04,2040,Multifamily,696,614,82,0.117816091954023
97.04,2040,Single Family - Detached,1798,1741,57,0.0317018909899889
97.04,2045,Mobile Home,0,0,0,
97.04,2045,Multifamily,696,595,101,0.145114942528736
97.04,2045,Single Family - Detached,1798,1739,59,0.0328142380422692
97.04,2050,Mobile Home,0,0,0,
97.04,2050,Multifamily,696,582,114,0.163793103448276
97.04,2050,Single Family - Detached,1798,1736,62,0.0344827586206897
97.05,2012,Mobile Home,0,0,0,
97.05,2012,Multifamily,432,397,35,0.0810185185185185
97.05,2012,Single Family - Detached,1092,1066,26,0.0238095238095238
97.05,2020,Mobile Home,0,0,0,
97.05,2020,Multifamily,862,836,26,0.0301624129930394
97.05,2020,Single Family - Detached,1094,1062,32,0.0292504570383912
97.05,2025,Mobile Home,0,0,0,
97.05,2025,Multifamily,862,838,24,0.0278422273781903
97.05,2025,Single Family - Detached,1094,1063,31,0.0283363802559415
97.05,2030,Mobile Home,0,0,0,
97.05,2030,Multifamily,862,830,32,0.037122969837587
97.05,2030,Single Family - Detached,1094,1062,32,0.0292504570383912
97.05,2035,Mobile Home,0,0,0,
97.05,2035,Multifamily,872,838,34,0.0389908256880734
97.05,2035,Single Family - Detached,1094,1063,31,0.0283363802559415
97.05,2040,Mobile Home,0,0,0,
97.05,2040,Multifamily,875,838,37,0.0422857142857143
97.05,2040,Single Family - Detached,1094,1062,32,0.0292504570383912
97.05,2045,Mobile Home,0,0,0,
97.05,2045,Multifamily,877,836,41,0.0467502850627138
97.05,2045,Single Family - Detached,1094,1061,33,0.030164533820841
97.05,2050,Mobile Home,0,0,0,
97.05,2050,Multifamily,878,835,43,0.0489749430523918
97.05,2050,Single Family - Detached,1094,1058,36,0.0329067641681901
97.06,2012,Mobile Home,0,0,0,
97.06,2012,Multifamily,462,437,25,0.0541125541125541
97.06,2012,Single Family - Detached,2509,2455,54,0.0215225189318454
97.06,2020,Mobile Home,0,0,0,
97.06,2020,Multifamily,462,432,30,0.0649350649350649
97.06,2020,Single Family - Detached,2586,2537,49,0.0189481825212684
97.06,2025,Mobile Home,0,0,0,
97.06,2025,Multifamily,462,434,28,0.0606060606060606
97.06,2025,Single Family - Detached,2586,2539,47,0.0181747873163186
97.06,2030,Mobile Home,0,0,0,
97.06,2030,Multifamily,462,427,35,0.0757575757575758
97.06,2030,Single Family - Detached,2587,2539,48,0.0185543100115964
97.06,2035,Mobile Home,0,0,0,
97.06,2035,Multifamily,462,423,39,0.0844155844155844
97.06,2035,Single Family - Detached,2587,2541,46,0.0177812137611133
97.06,2040,Mobile Home,0,0,0,
97.06,2040,Multifamily,462,419,43,0.0930735930735931
97.06,2040,Single Family - Detached,2587,2537,50,0.0193274062620796
97.06,2045,Mobile Home,0,0,0,
97.06,2045,Multifamily,462,414,48,0.103896103896104
97.06,2045,Single Family - Detached,2587,2535,52,0.0201005025125628
97.06,2050,Mobile Home,0,0,0,
97.06,2050,Multifamily,462,411,51,0.11038961038961
97.06,2050,Single Family - Detached,2587,2523,64,0.0247390800154619
98.01,2012,Mobile Home,0,0,0,
98.01,2012,Multifamily,731,692,39,0.0533515731874145
98.01,2012,Single Family - Detached,1556,1532,24,0.0154241645244216
98.01,2020,Mobile Home,0,0,0,
98.01,2020,Multifamily,731,695,36,0.0492476060191518
98.01,2020,Single Family - Detached,1557,1532,25,0.0160565189466924
98.01,2025,Mobile Home,0,0,0,
98.01,2025,Multifamily,735,717,18,0.0244897959183673
98.01,2025,Single Family - Detached,1557,1538,19,0.0122029543994862
98.01,2030,Mobile Home,0,0,0,
98.01,2030,Multifamily,735,717,18,0.0244897959183673
98.01,2030,Single Family - Detached,1557,1538,19,0.0122029543994862
98.01,2035,Mobile Home,0,0,0,
98.01,2035,Multifamily,735,717,18,0.0244897959183673
98.01,2035,Single Family - Detached,1557,1541,16,0.0102761721258831
98.01,2040,Mobile Home,0,0,0,
98.01,2040,Multifamily,735,717,18,0.0244897959183673
98.01,2040,Single Family - Detached,1557,1539,18,0.0115606936416185
98.01,2045,Mobile Home,0,0,0,
98.01,2045,Multifamily,735,717,18,0.0244897959183673
98.01,2045,Single Family - Detached,1557,1538,19,0.0122029543994862
98.01,2050,Mobile Home,0,0,0,
98.01,2050,Multifamily,735,717,18,0.0244897959183673
98.01,2050,Single Family - Detached,1557,1538,19,0.0122029543994862
98.02,2012,Mobile Home,0,0,0,
98.02,2012,Multifamily,946,939,7,0.00739957716701903
98.02,2012,Single Family - Detached,1573,1556,17,0.0108073744437381
98.02,2020,Mobile Home,0,0,0,
98.02,2020,Multifamily,946,941,5,0.00528541226215645
98.02,2020,Single Family - Detached,1573,1555,18,0.0114431023521933
98.02,2025,Mobile Home,0,0,0,
98.02,2025,Multifamily,993,982,11,0.0110775427995972
98.02,2025,Single Family - Detached,1573,1562,11,0.00699300699300699
98.02,2030,Mobile Home,0,0,0,
98.02,2030,Multifamily,1029,1018,11,0.010689990281827
98.02,2030,Single Family - Detached,1573,1562,11,0.00699300699300699
98.02,2035,Mobile Home,0,0,0,
98.02,2035,Multifamily,1029,1018,11,0.010689990281827
98.02,2035,Single Family - Detached,1573,1564,9,0.00572155117609663
98.02,2040,Mobile Home,0,0,0,
98.02,2040,Multifamily,1029,1016,13,0.0126336248785228
98.02,2040,Single Family - Detached,1579,1566,13,0.00823305889803673
98.02,2045,Mobile Home,0,0,0,
98.02,2045,Multifamily,1029,1016,13,0.0126336248785228
98.02,2045,Single Family - Detached,1579,1565,14,0.00886637112096264
98.02,2050,Mobile Home,0,0,0,
98.02,2050,Multifamily,1029,1016,13,0.0126336248785228
98.02,2050,Single Family - Detached,1579,1565,14,0.00886637112096264
98.04,2012,Mobile Home,0,0,0,
98.04,2012,Multifamily,1,0,1,1
98.04,2012,Single Family - Detached,1842,1814,28,0.0152008686210641
98.04,2020,Mobile Home,0,0,0,
98.04,2020,Multifamily,1,1,0,0
98.04,2020,Single Family - Detached,1842,1812,30,0.0162866449511401
98.04,2025,Mobile Home,0,0,0,
98.04,2025,Multifamily,1,0,1,1
98.04,2025,Single Family - Detached,1842,1819,23,0.0124864277958741
98.04,2030,Mobile Home,0,0,0,
98.04,2030,Multifamily,1,0,1,1
98.04,2030,Single Family - Detached,1842,1819,23,0.0124864277958741
98.04,2035,Mobile Home,0,0,0,
98.04,2035,Multifamily,1,1,0,0
98.04,2035,Single Family - Detached,1842,1821,21,0.011400651465798
98.04,2040,Mobile Home,0,0,0,
98.04,2040,Multifamily,1,0,1,1
98.04,2040,Single Family - Detached,1843,1818,25,0.0135648399348888
98.04,2045,Mobile Home,0,0,0,
98.04,2045,Multifamily,1,0,1,1
98.04,2045,Single Family - Detached,1843,1815,28,0.0151926207270754
98.04,2050,Mobile Home,0,0,0,
98.04,2050,Multifamily,1,0,1,1
98.04,2050,Single Family - Detached,1843,1815,28,0.0151926207270754
98.05,2012,Mobile Home,0,0,0,
98.05,2012,Multifamily,212,212,0,0
98.05,2012,Single Family - Detached,1816,1781,35,0.019273127753304
98.05,2020,Mobile Home,0,0,0,
98.05,2020,Multifamily,212,212,0,0
98.05,2020,Single Family - Detached,1815,1778,37,0.0203856749311295
98.05,2025,Mobile Home,0,0,0,
98.05,2025,Multifamily,212,207,5,0.0235849056603774
98.05,2025,Single Family - Detached,1821,1791,30,0.0164744645799012
98.05,2030,Mobile Home,0,0,0,
98.05,2030,Multifamily,223,217,6,0.0269058295964126
98.05,2030,Single Family - Detached,1831,1799,32,0.0174767886400874
98.05,2035,Mobile Home,0,0,0,
98.05,2035,Multifamily,223,218,5,0.0224215246636771
98.05,2035,Single Family - Detached,1838,1809,29,0.0157780195865071
98.05,2040,Mobile Home,0,0,0,
98.05,2040,Multifamily,223,217,6,0.0269058295964126
98.05,2040,Single Family - Detached,1843,1810,33,0.0179055887140532
98.05,2045,Mobile Home,0,0,0,
98.05,2045,Multifamily,223,216,7,0.031390134529148
98.05,2045,Single Family - Detached,1843,1809,34,0.0184481823114487
98.05,2050,Mobile Home,0,0,0,
98.05,2050,Multifamily,223,215,8,0.0358744394618834
98.05,2050,Single Family - Detached,1843,1809,34,0.0184481823114487
99.01,2012,Mobile Home,0,0,0,
99.01,2012,Multifamily,8,7,1,0.125
99.01,2012,Single Family - Detached,0,0,0,
99.01,2020,Mobile Home,0,0,0,
99.01,2020,Multifamily,8,8,0,0
99.01,2020,Single Family - Detached,0,0,0,
99.01,2025,Mobile Home,0,0,0,
99.01,2025,Multifamily,8,8,0,0
99.01,2025,Single Family - Detached,0,0,0,
99.01,2030,Mobile Home,0,0,0,
99.01,2030,Multifamily,8,8,0,0
99.01,2030,Single Family - Detached,0,0,0,
99.01,2035,Mobile Home,0,0,0,
99.01,2035,Multifamily,8,8,0,0
99.01,2035,Single Family - Detached,0,0,0,
99.01,2040,Mobile Home,0,0,0,
99.01,2040,Multifamily,8,8,0,0
99.01,2040,Single Family - Detached,0,0,0,
99.01,2045,Mobile Home,0,0,0,
99.01,2045,Multifamily,8,8,0,0
99.01,2045,Single Family - Detached,0,0,0,
99.01,2050,Mobile Home,0,0,0,
99.01,2050,Multifamily,8,7,1,0.125
99.01,2050,Single Family - Detached,0,0,0,
99.02,2012,Mobile Home,0,0,0,
99.02,2012,Multifamily,0,0,0,
99.02,2012,Single Family - Detached,0,0,0,
99.02,2020,Mobile Home,0,0,0,
99.02,2020,Multifamily,0,0,0,
99.02,2020,Single Family - Detached,0,0,0,
99.02,2025,Mobile Home,0,0,0,
99.02,2025,Multifamily,0,0,0,
99.02,2025,Single Family - Detached,0,0,0,
99.02,2030,Mobile Home,0,0,0,
99.02,2030,Multifamily,0,0,0,
99.02,2030,Single Family - Detached,0,0,0,
99.02,2035,Mobile Home,0,0,0,
99.02,2035,Multifamily,0,0,0,
99.02,2035,Single Family - Detached,0,0,0,
99.02,2040,Mobile Home,0,0,0,
99.02,2040,Multifamily,0,0,0,
99.02,2040,Single Family - Detached,0,0,0,
99.02,2045,Mobile Home,0,0,0,
99.02,2045,Multifamily,0,0,0,
99.02,2045,Single Family - Detached,0,0,0,
99.02,2050,Mobile Home,0,0,0,
99.02,2050,Multifamily,0,0,0,
99.02,2050,Single Family - Detached,0,0,0,